abase=v.貶抑,使卑下
abash=v.使害羞
abate=v.減輕,減少
abdicate=v.讓位
abduct=v.綁架
aberrant=adj.違反常規的;異常的
abet=v.教唆
abeyance=n.終止,擱置
abhorrence=n.嫌惡
abject=adj.卑下的
abjure=v.公開放棄
abnegate=v.克制,放棄(權利、要求等)
abode=n.住處
abolition=n.廢除
abominable=adj.可惡的
abrade=v.磨損
abridge=v.刪減;縮短
abrogate=v.廢止,撤銷
abscission=n.切除
abscond=v.潛逃
absolve=v.赦免,免除
abstain=v.戒絕
abstemious=adj.有節制的
abstinence=n.節制,禁欲
abstruse=adj.深奧難懂的
abut=v.鄰接,毗連
abysmal=adj.極深的,糟透的
accede=v.同意
accentuate=v.強調
accessory=adj.附屬的;n.配件
acclaim=v.歡呼,稱讚
acclimate=v.使適應
acclivity=n.向上的陡坡
accolade=n.讚揚
accomplice=n.幫兇
accost=v.搭訕
accoutered=adj.裝備的
accrete=v.堆積
accrue=v.增加
accumulate=v.積聚
acerbic=adj.苦澀的;刻薄的
acidulous=adj.有酸味的;刻薄的
acme=n.頂點
acoustic=adj.聽覺的,原聲的
acquiesce=v.默認
acquittal=n.宣告無罪
acrimony=n.尖酸刻薄
acronym=n.首字母簡略詞
acrophobia=n.懼高症
actuate=v.啟動,激勵
acumen=n.敏銳,精明
adage=n.格言
adamant=adj.堅強的,堅定不移的
addendum=n.補充,附錄
addle=v.使糊塗
addlepated=adj.頭腦不清的,糊塗的
adduce=v.引證,舉例
adjacent=adj.鄰近的,毗連的
adjourn=v.使延期
adjudicate=v.判決
adjunct=n.附加物
adjure=v.命令,囑咐
ad-lib=v.adv.即席地(做某事)
administer=v.提供,給予
admonish=v.訓誡;警告
adorn=v.裝飾
adroit=adj.熟練的
adulate=v.諂媚
adulterate=v.摻假
adumbrate=v.預示
adventitious=adj.偶然的
adversary=n.對手
adversity=n.不幸,災禍
aegis=n.防衛
aerate=v.充氣
aeronautics=n.航空學
aesthetic=adj.審美的
affable=adj.和藹的,親切的
affectation=n.做作
affectionate=adj.充滿感情的
affidavit=n.宣誓書
affiliate=v.加入;聯合
affinity=n.密切關係
affirm=v.贊成;肯定;聲明
affix=v.黏上,貼上
afflict=v.使痛苦,折磨
affluent=adj.豐富的
affray=n.打鬥
affront=v.n.公開侮辱
aftermath=n.事件的餘波
agape=adj.adv.目瞪口呆地
agglomerate=v.凝聚,結塊
aggrandize=v.增大,擴張
aggravate=v.惡化;激怒
aggregate=v.集合
aggressive=adj.侵略的,進取的
aggrieve=v.使煩惱
aghast=adj.驚恐的
agile=adj.敏捷的
agnostic=adj.不可知論的
agog=adj.興奮的,急切的
agony=n.極大痛苦
agrarian=adj.土地的,農業的
agronomy=n.農學
airborne=adj.空氣傳播的
airtight=adj.密封的,無懈可擊的
alacrity=n.迅速,爽快
alias=n.化名
alibi=n.不在場證明,托辭
alienate=v.疏遠
alimentary=adj.食物的,營養的
alimony=n.贍養費
allay=v.減輕,緩和
allege=v.主張,宣稱
allegiance=n.忠誠
allegory=n.寓言
alleviate=v.緩和,減輕
alliteration=n.頭韻
allocate=v.分配
allude=v.提及,暗指
alluvial=adj.沖積的
aloft=adv.在空中
altercation=n.爭吵,爭論
altruism=n.利他主義
altruistic=adj.利他的
amalgamate=v.合併;聯合
ambidextrous=adj.十分靈巧的,左右開弓的
ambience=n.環境,氣氛
ambivalent=adj.矛盾的
amble=v.漫步
ambulatory=adj.走動的,不需臥床的
ameliorate=v.改善
amenable=adj.願服從的,通情達理的
amenity=n.舒適,便利設施
amiable=adj.和藹的,友善的
amicable=adj.友善的
amnesia=n.健忘症
amnesty=n.赦免
amorous=adj.多情的,戀愛的
amorphous=adj.無定形的;雜亂的
amortize=v.分期償還
amphibian=n.兩棲類的,水陸兩用的
amplify=v.放大,增強
amputate=v.截肢
amuck=adv.狂亂地
amulet=n.護身符
anachronism=n.年代錯誤
anaerobic=adj.厭氧的
anagram=n.回文構詞法
analgesic=n.鎮痛劑
analogy=n.類似,類推
anarchy=n.無政府狀態
anathema=n.詛咒
anatomy=n.解剖學
ancillary=adj.輔助的,從屬的
anecdote=n.軼事
anemia=n.貧血
anesthetic=n.麻醉劑
anguish=n.極大痛苦
anhydrous=adj.無水的
animadversion=n.批評
animosity=n.憎惡,仇恨
animus=n.憎恨
annexation=n.併吞,附加
annihilate=v.消滅,徹底擊敗
annotate=v.註解
annuity=n.年金
annul=v.取消,廢除
anodyne=n.止痛藥;adj.不得罪人的
anomaly=n.異常
anorexia=n.厭食症
antagonize=v.反對,對抗
antecedent=n.居先,前身
antediluvian=adj.史前的,古老的
antenna=n.觸角,直覺
anthology=n.詩集,文集
anthropology=n.人類學
anticlimax=n.突降法,虎頭蛇尾
antidote=n.解毒藥
antigen=n.抗原
antihistamine=n.(治療過敏的)抗組胺劑
antipathy=n.反感,厭惡
antiquated=adj.陳舊的
antiseptic=adj.防腐的,殺菌的
antithesis=n.對立面
apathy=n.冷淡
apex=n.頂點
aphasia=n.失語症
aphorism=n.格言,警語
apiculture=n.養蜂業
aplomb=n.沉著
apocalyptic=adj.天啟的
apocryphal=adj.假冒的
apogee=n.最高點,遠地點
apoplectic=adj.勃然大怒的;中風的
apostate=n.變節者
apostatize=v.放棄信仰,脫黨,變節
apothecary=n.藥劑師
apothegm=n.格言,警句
appall=v.使驚駭
apparatus=n.儀器,設備
apparel=n.衣服
apparition=n.鬼怪,幽靈
appease=v.平息,安撫
appellant=n.控訴人
appellation=n.名稱,稱呼
appendage=n.附加物
apposite=adj.適當的
appraise=v.評價
apprehend=v.理解,擔憂,逮捕
apprise=v.通知
approbation=n.稱讚,認可
appropriate=v.盜用
appurtenance=n.所有物,生活物品
apropos=prep.adj.(與先前)適宜或有關的
aqueduct=n.溝渠
arable=adj.適合種植的
arbitrary=adj.霸道的;隨機的
arboreal=adj.樹木的
arcade=n.騎樓
arcane=adj.神秘的,秘密的
archaic=adj.古代的,古色古香的
archetype=n.原型
archipelago=n.群島
ardent="adj.熱情的
arduous=adj.艱巨的;費力的
argot=n.行話
arid=adj.乾旱的
aristocracy=n.貴族政府
armada=n.艦隊
armistice=n.休戰
aromatic=adj.芳香
arraign=v.傳訊;控告
array=v.部署,展示;顯示;n.大量
arrears=n.負債
arresting=adj.迷人的
arrogate=v.霸占
arroyo=n.小溪
arsenal=n.軍械庫
arson=n.縱火
artery=n.動脈
arthritis=n.關節炎
articulate=v.清楚說話;形成關節;adj.口齒伶俐的
artifact=n.人工製品
artifice=n.詭計
artillery=n.大炮
artisan=n.技工;adj.傳統匠人手工製作的
ascendancy="n.支配(或統治)地位
ascetic=adj.禁欲的;n.苦行者
ascribe=v.把...歸因於
asinine=adj.愚蠢的
askance=adv.斜目而視
askew=adj.歪斜的
asperity=n.粗暴,刻薄
aspersion=n.誹謗,中傷
asphyxiate=v.(使)窒息而死
assail=v.猛攻,批評
assault=v.猛襲
assay=v.n.試驗,鑒定
assent=v.同意
assert=v.斷言,主張
assiduous=asj.勤勉的
assimilate=v.同化
assorted=adj.各種各樣的
assuage=v.減輕;緩和
asteroid=n.小行星
asthma=n.氣喘
astringent=adj.嚴厲的,⽌⾎的
astrology=n.占星術
astronomical=adj.天文的,天文數字的
astute=adj.精明的;機敏的
asunder=adv.碎;散
asylum=n.避難所
asynchronous=adj.非同步的
atheism=n.無神論
atlas=n.地圖集
atone=v.贖罪,補償
atrocious=adj.糟糕的,殘暴的
atrophy=v.n.萎縮
attenuate=v.變薄,變弱
attest=v.證實
attire=v.穿著;n.衣服
attorney=n.律師
attrition=n.消耗
attune=v.使調和,適應
audacious=adj.大膽的
audit=v.審計,查帳,旁聽
augment=v.增大,增加
augury=n.預兆
august=adj.威嚴的
auspices=n.資助
austere=adj.簡樸的;苦行的
authenticate=v.證明(某物)為真
autocrat=n.獨裁者
automaton=n.機器人
autopsy=n.驗屍
avalanche=n.雪崩
avant-garde=adj.先鋒,先驅的
avarice=n.貪婪
aver=v.斷言,主張
averse=adj.反感的
avert=v.避免
aviary=n.鳥舍
avid=adj.渴望的;貪婪的
avocation=n.副業,嗜好
avow=v.公開宣稱(某事物);承認
awry=adv.歪;斜
axiom=n.格言,公理
azure=adj.蔚藍的
babble=v.含糊不清地說;嘮嘮叨叨
bacchanal=n.(行為放縱的)狂歡會
backdrop=n.(事情的)背景
backslide=v.故態復萌,墮落
badger=v.一再煩擾
badinage=n.開玩笑
baffle=v.使困惑
baleful=adj.凶惡的;有害的
balk=v.阻礙,畏怯
ballerina=n.芭蕾舞女演員
balmy=adj.(氣候)溫和的,芳香的
bamboozle=v.哄騙,使為難
banal=adj.陳腐的
bandy=adj.膝內翻的;v.相互投擲,議論
baneful=adj.有害的
banish=v.放逐某人;打消(念頭)
banter=v.n.開玩笑
barefaced=adj.厚顏無恥的
barometer=n.氣壓針
baron=n.工業巨頭
barrage=n.堰,一大堆(問題﹑批評等)
barricade=n.障礙物
barrister=n.訟務律師
barter=v.交換
bashful=adj.害羞的
bask=v.曬太陽,取暖
bastion=n.堡壘
bathetic=adj.陳腐的
battalion=n.軍營
bazaar=n.市集
beatific=adj.慈祥的,快樂的
bedeck=v.裝飾
bedizen=v.俗麗地穿著...
bedraggled=adj.弄濕或弄髒的;不整齊的
bedridden=adj.久病的
befuddle=v.使迷惑
begrudge=v.忌妒,吝嗇
beguile=v.欺騙
beholden=adj.感激某人的
behoove=v.為必要
belabor=v.過分說明,批評
beleaguer=v.圍攻
belie=v.掩飾
bellicose=adj.好戰的
belligerent=adj.好鬥,好戰的
bellwether=n.領頭羊
bemoan=v.因...悲傷,抱怨
benediction=n.祝福
benefactor=n.恩人,捐助者
beneficiary=n.受益人
benevolent=adj.善心的
benighted=adj.無知的
benign=adj.(病)良性的,(氣候)良好的,仁慈的
bequest=n.遺產
berate=v.嚴厲責備
berserk=adj.狂怒的
beseech=v.哀求
beset=v.困擾
besiege=v.圍攻,圍住
besmirch=v.玷汙,誹謗
bespeak=v.證明(某事物);表示
bestial=adj.野獸的,殘忍的
bestow=v.贈與
bete noire=n.令人討厭的人事物
betoken=v.預示
betroth=v.把...許配給
bewilder=v.迷惑,混亂
bibliography=n.參考書目
bicker=v.(為小事)爭吵
biennial=adj.兩年一次的
bifurcate=v.分叉
bigotry=n.頑固,偏執
bilious=adj.易怒的
billow=n.巨浪;如波濤之物
bivouac=n.露天,臨時營地
blackball=v.投反對票以阻止
blanch=v.(因害怕﹑寒冷等而)臉色蒼白
blandish=v.奉承
blase=adj.厭倦的
blasphemy=n.褻瀆神靈
blatant=adj.厚顏無恥的,公然的
bleach=v.將...漂白;n.漂白劑
bleak=adj.荒涼的,寒冷的
blemish=v.玷汙
blighted=adj.枯萎的
blissful=adj.極幸福的
blithe=adj.快樂的
blizzard=n.暴風雪
blowhard=n.自吹自擂者
bludgeon=v.連擊,強迫某人做...
blunt=adj.鈍的;直率的
blurt=v.脫口說出
bluster=v.狂風猛刮;咆哮
bog=n.沼澤;v.使...陷入泥沼
boggle=v.遲疑,退縮;驚奇
bogus=adj.假的
bohemian=n.adj.放蕩不羈的(人)
boisterous=adj.喧鬧的
bombast=n.浮誇的言語
bon mot=n.警句,妙語
bonhomie=n.和藹
boorish=adj.粗野的
botany=n.植物學
botch=v.(笨手笨腳地)弄壞某事物
boulder=n.巨石
bounteous=adj.慷慨的
bountiful=adj.慷慨的,(數量)異常大的
bowdlerize=v.刪除(書等的)不妥的文句
boycott=v.抵制(貿易)
brackish=adj.鹹的
braggadocio=n.自吹自擂
bramble=n.荊棘
brandish=v.得意地或威脅地揮動
brash=adj.盛氣淩人的
bravado=n.虛張聲勢
bravura=n.不必要的大膽嘗試
brawl=n.打架
brawny=adj.(人)強壯的
brazen=adj.厚顏無恥的,黃銅制的
breach=v.n.違反,中斷
bridle=v.控制(感情等)
brigand=n.強盜
brisk=adj.敏捷的;活潑的
bristle=n.短而硬的毛髮;v.發怒
broach=v.開始商討
bromide=n.陳腐的想法或言語
brook=v.忍受,小溪
browbeat=v.嚇唬某人;欺侮
bruit=v.散佈(謠言)
brunt=n.主要衝擊⼒或影響
brusque=adj.唐突的,魯莽的
bucolic=adj.田園生活的
budge=v.稍微移動
buffoon=n.滑稽有趣的人
bulwark=n.堡壘,保障
bumptious=adj.自負的,傲慢的
buoyant=adj.能漂浮的,樂天的
burgeon=v.迅速成長,發展
burlesque=n.嘲諷性作品
burnish=v.擦亮,磨光
burrow=n.地洞;v.挖洞
buttress=v.支持或加強某事物
byzantine=adj.拜占庭帝國的,複雜難解的
cabal=n.陰謀
cacophony=n.刺耳的聲音
cadaver=n.屍體
cadge=v.占便宜
cajole=v.哄騙
calamity=n.災難
caliber=n.口徑,才幹
callous=adj.冷漠的
callow=adj.乳臭未乾的
calumniate=v.誹謗,中傷
camaraderie=n.友情,情誼
camouflage=v.n.(軍事)偽裝,掩飾
canard=n.謊報;謠傳
candid=adj.直率的
candor=n.坦白,公正
canine=adj.犬的
canker=n.禍根,口瘡
cannibal=adj.同類相食,吃人肉
canny=adj.精明仔細的
canonical=adj.符合規定的,經典的
cantankerous=adj.脾氣壞的
canter=v.(指馬)慢跑
canvass=v.在政治方面遊說
capacious=adj.寬敞的
capillary=n.微血管
capitulate=v.投降
caprice=n.突如其來的念頭,反覆無常
capsize=v.n.使翻船
captious=adj.吹毛求疵的
carcinogen=n.致癌物
cardinal=adj.最重要的
careen=v.(船)傾斜
caricature=n.諷刺畫,滑稽模仿
carnage=n.大屠殺
carnivore=n.食肉動物
carouse=v.狂飲作樂
carp=v.吹毛求疵
carrion=n.腐肉
carte blanche=n.全權,絕對的自主權
cascade=n.瀑布,v.如瀑布落下
castigate=v.嚴厲批評
cataclysm=n.巨變,災難
catalyst=n.催化劑
cataract=n.大瀑布,白內障
categorical=adj.絕對的,明確的
catharsis=n.宣洩,淨化
cathedral=n.大教堂
catholic=adj.包羅萬象的
caucus=n.黨團
caustic=adj.腐蝕性的,譏諷的
cavalcade=n.遊行
cavalier=n.騎士
cavil=v.吹毛求疵
cavort=v.歡躍
celestial=adj.天空的,天國的
cemetery=n.墳墓,公墓
censor=v.審查;n.審查員
censure=v.責難
centrifugal=adj.離心的
ceramics=n.製陶業
cerebral=adj.大腦的,理智的;有智力的
cerebration=n.思想
certitude="n.確信,確實
cessation=n.中止;中斷
chafe=v.摩擦
chagrin=n.懊惱
champion=v.支持
chancellor=n.總理,首相
charade=n.明顯的偽裝,比手畫腳
charisma=n.領袖氣質;魅力
charlatan=n.庸醫,騙子
chary=adj.謹慎的
chassis=n.車子底盤
chasten=v.懲罰,磨鍊
chattel=n.私人財產
chatterbox=n.多話者
chauvinism=n.沙文主義
checkered=adj.有方格的,成敗參半的
cherubic=adj.天使般的
chicanery=n.欺騙
chide=v.叱責,指責
chimera=n.幻想,妄想
chiropodist=n.足科醫生
chivalrous=adj.武士精神的,俠義的
choleric=adj.易怒的
choreography=n.編舞,舞藝
chortle=v.大聲的笑
chromatic=adj.彩色的
chronological=adj.按時間順序的
chrysanthemum=n.菊花
churlish=adj.脾氣暴躁的,吝嗇的
cicerone=n.導遊
cipher=n.零,密碼
circuitous=adj.迂回的
circumference=n.圓周
circumlocution=n.轉彎抹角說話
circumscribe=v.限制
circumspect=adj.小心謹慎的
circumvent=v.逃避,規避,繞過
clairvoyance="n.洞察力
clamorous=adj.吵鬧的
clandestine=adj.秘密的
clannish=adj.排外的,小集團的
clarion=adj.響亮的
claustrophobia="n.幽閉恐怖症
cleavage=n.分裂
clement=adj.溫和的,仁慈的
clench=v.握緊;咬緊(牙關)
cloudburst=n.暴雨
clout=n.影響力
coadjutor=n.助手
coagulate=v.使凝結
coalesce=v.聯合,合併
coax=v.勸誘
coddle=v.悉心照料某人
coffer=n.保險櫃
cogent=adj.有說服力的
cogitate=v.仔細思考
cognizant=adj.知道的
cognomen=n.姓
cohabit=v.(未婚)雙方同居
cohesive=adj.凝聚的
cohort=n.群
coiffure=n.髮型
collage=n.拼貼畫
collate=v.校對
collateral=n.擔保品;adj.並行的,附帶的
colloquium=n.學術討論會
collude=v.共謀,串通
colossal=adj.巨大的
comatose=adj.昏迷的
combustible=adj.易燃的
comestible=n.食物;adj.可吃的
comity=n.禮儀
commandeer=v.徵用
commendable=adj.值得讚揚的
commensurate=adj.大小同樣的;相稱的
commingle=v.混合
commiserate=v.憐憫,同情
commodious=adj.寬敞的
commodity=n.日用品
commonplace=adj.平凡的,老生常談的
commotion=n.騷動,動亂
communal=adj.公共的
compact=adj.簡潔的,小型的;n.協議
compendious=adj.扼要的
compile=v.彙集
complacent=adj.自滿的
complaisant=adj.順從的,討好的
complicity=n.合謀,串通
comport=v.舉止,行為
composite=adj.混合成的;n.合成物
composure=n.鎮靜
compromise=v.危害
compunction=n.良心的譴責
concave=adj.凹的
conceive=v.構想;懷孕
concerted=adj.共同籌劃的,一致的
conciliate=v.安撫
concise=adj.簡潔的
conclave=n.秘密會議
concoct=v.調製,捏造
concomitant=adj.伴隨的
concord=n.和諧
concurrent=adj.同時的
concussion=n.腦震盪
condescend=v.屈尊
condign=adj.(懲罰)應得的
condiment=n.調味品
condole=v.安慰,哀悼
condone=v.寬恕,赦免
conduce=v.有助於,促成
conduit=n.溝渠;水管
confection=n.甜食
confer=v.討論,給予
configuration=n.結構,配置
confiscate=v.沒收
conflagration=n.大火
conflate=v.將(兩種資料﹑文本)合併
confluence=n.匯流
confound=v.使迷惑,弄錯
confute=v.反駁
congeal=v.凍結,凝固
congenial=adj.意氣相投的
congenital=adj.天生的
congest=v.充滿,擁擠
congregate=v.聚集
congruent=adj.全等的,一致的
conjecture=n.推測,猜想
conjugal=adj.婚姻的
conjure=v.懇求,變魔法
connive=v.默許
connoisseur=n.鑒賞家
connotation=n.言外之意
connubial=adj.婚姻的
conquest=n.征服
consanguinity=n.血親
conscript=v.徵兵
consecrate=v.把...奉獻,奉...為神聖
consequential=adj.重大的,必然的
consign=v.托運,委托
console=v.安慰
consolidate=v.鞏固
consonance=n.和諧
consort=v.交往
conspicuous=adj.顯著的
conspire=v.陰謀,共謀
constellation=n.星群
consternation=n.驚恐
constipation=n.便秘
constrain=v.強迫,強制
constrict=v.壓縮
construe=v.解釋,分析
consummate=v.完成;adj.完美的
contemplate=v.深思
contemptuous=adj.藐視的
contentious=adj.好爭吵的
contiguous=adj.鄰近的
contingency=n.偶發事件
contort=v.扭曲
contraband=n.違禁品
contravene=v.違反
contrite=adj.痛悔的
contrive=v.謀劃
controvert=v.反駁
contumacy=n.無禮,傲慢
contusion=n.瘀傷
conundrum=n.謎語
convalesce=v.康復
convene=v.集合;召集
converge=v.聚合
conversant=adj.精通的
convex=adj.凸出的
convivial=adj.歡樂的
convocation=n.召集,會議
convoke=v.召集
convoluted=adj.旋繞的,複雜的
convoy=v.護送
convulse=v.震動,使抽筋
copious=adj.豐富的,大量的
cordial=adj.熱忱的
cordon=n.警戒線
cornucopia=n.富饒之源;寶藏
corollary=n.推論,必然的結果
corporal=adj.身體的
corporeal=adj.肉體的,物質的
corpulent=adj.肥胖的
corroborate=v.證實,加強
corrode=v.腐蝕,侵蝕
corrugate=v.起皺
corsair=n.海盜
cosmopolitan=adj.世界性的
cosset=v.寵愛
countermand=v.撤消
covenant=n.契約
covert=adj.隱蔽的
covetous=adj.貪婪的
cower=v.畏縮
cozen=v.欺瞞
crabbed=adj.脾氣壞的
craggy=adj.有峭壁的,
cranky=adj.壞脾氣的
crater=n.火山口
craven=adj.膽小的
credence=n.相信,信任
credo=n.信條
credulous=adj.輕信的
creed=n.信條
crescendo=n.(音樂)漸強
crescent=n.新月;adj.逐漸增大的
crestfallen=adj.失望的
crevice=n.缺口
cringe=v.畏縮,卑躬屈膝
criterion=n.標準
cronyism=n.任用親信
crotchety=adj.脾氣壞的
crumble=v.弄碎
crustacean=n.甲殼類動物
crux="n.症結點
cryogenic=adj.深凍冷藏的
cryptic=adj.秘密的
cubicle=n.小隔間
culinary=adj.烹飪的
culminate=v.達到頂點
culpable=adj.該責備的,有罪的
cultivate=v.耕作,培養
cumbersome=adj.笨重的
cumulative=adj.累積的
cupidity=n.貪婪
curator=n.(博物館,動物園等)館,園長
curfew=n.宵禁
curmudgeon=n.脾氣不好的人
cursory=adj.粗略的,草率的
cynical=adj.憤世嫉俗的
cynosure=n.人們注意的焦點
dabble=v.涉獵,戲水
dainty=n.精美食品;adj.挑剔的
dally=v.浪費時間
dapper=adj.整齊的
daredevil=n.膽大的人
dastardly=adj.懦弱的
daunt=v.威嚇
dawdle=v.閒晃,虛度
dazzle=v.(使)眼花
deadlock=n.僵局
deadpan=adj.假裝正經的
dearth=n.缺乏
debacle=n.突然的大失敗
debar=v.阻止,禁止
debark=v.使下船
debase=v.貶低,降低
debauch=v.使放蕩,墮落
debilitate=v.使衰弱
debonair=adj.風度翩翩的
debrief=v.向...詢問情況
debunk=v.揭穿真相
decadence=n.衰落,頹廢
decant=v.慢慢倒出
decapitate=v.斬首,解僱
deciduous=adj.脫落的;落葉的
decimate=v.大量毀滅
declaim=v.高談闊論
declivity=n.斜坡
decompose=v.(使)腐爛
decorum=n.禮節,禮貌
decoy=v.誘騙
decree=n.命令,法令
decrepit=adj.衰老的,破舊的
decry=v.公開譴責
deduce=v.演繹
deface=v.損壞
defalcate=v.盜用公款
defamatory=adj.誹謗的
defect=n.瑕疵;v.變節
deferential=adj.順從的,恭順的
defiant=adj.挑釁的,目中無人的
defile=v.弄汙,弄髒
deforestation=n.濫伐森林
defraud=v.欺騙某人
defray=v.付款
deft=adj.靈巧的
defunct=adj.死亡的,已廢止的
degenerate=v.退步;墮落
dehydrate=v.脫水
deign=v.屈尊
dejected=adj.沮喪的
delectable=adj.好吃的,愉快的
delegate=n.代表
deleterious=adj.有害的
delineate=v.畫出或描述出
delinquency=n.失職
delirious=adj.神志昏亂的,特別愉快的
delude=v.欺騙
deluge=n.大洪水;v.淹沒
delve=v.鑽研,搜索
demagogue=n.煽動者
demarcate=v.劃分,劃界
demean=v.貶低
demeanour=n.舉止,行為
demented=adj.瘋狂的
demesne=n.領域
demise=n.死亡
demography=n.人口學
demolish=v.破壞
demote=v.降級,降職
demotic=adj.民眾的;通俗的
demur=v.表示異議
demure=adj.端莊的,文靜的
denigrate=v.污蔑,誹謗
denizen=n.居民
denominate=v.(以某種貨幣)表示金額
denote=v.表示
denouement=n.結局
denounce=v.公開指責
deplete=v.倒空;耗盡
deplore=v.痛惜
deportation=n.驅逐出境
deportment=n.舉止行為
depose=v.免職
deposition=n.罷免,證詞
depraved=adj.墮落的,腐化的
deprecate=v.反對,輕視
depreciate=v.貶低;貶值
depredation=n.掠奪
derangement=n.精神錯亂
derelict=adj.怠忽職守的
deride=v.嘲弄
derivation=n.發展,派生
dermatology=n.皮膚學
derogate=v.貶損
descant=n.伴唱,伴奏
descry=v.遠遠看到,發現
desecrate=v.玷辱,褻瀆
desiccant=n.乾燥劑
desideratum=n.必需品
desist=v.終止
desolate=adj.荒涼的,孤獨的
desperado=n.亡命之徒
despicable=adj.可鄙的,卑劣的
despise=v.輕視
despoil=v.破壞,洗劫
despondent=adj.意氣消沉的
despotic=adj.專橫的
destitute=adj.貧乏的;窮困的
desuetude=n.廢止
desultory=adj.散漫的
detached=adj.冷淡的
detergent=n.清潔劑
deteriorate=v.(使)變壞,惡化
detonate=v.(使)爆炸
detoxicate=v.除毒
detraction=n.貶低,誹謗
detrimental=adj.損害的
deviate=v.越軌
devolve=v.(指工作,職務)移交給某人
dexterous=adj.靈巧的
diabolical=adj.惡魔的,殘忍的
diaphanous=adj.輕薄透明的
diatribe=n.抨擊
dichotomy=n.二分法
didactic=adj.教誨的
diffidence=n.缺乏自信
diffuse=v.散播,擴散
digress=v.離題
dilapidated=adj.殘破的
dilatory=adj.慢吞吞的,拖延的
dilettante=n.業餘愛好者
diminutive=adj.小的
dimple=n.酒窩
dipsomania=n.嗜酒狂
dirge=n.輓歌
disabuse=v.使省悟
disaffect=v.使...感情疏遠
disarray=n.紊亂
disavow=v.否定
disband=v.解散
disburse=v.支付
discard=v.扔掉,出(牌)
discern=v.認出
discombobulate=v.使困惑,打亂
discomfit=v.使困惑,尷尬
discommode=v.給...添麻煩
disconsolate=adj.憂悶的
discord=n.不和,紛爭
discountenance=v.不贊成
discreet=adj.謹慎的
discrepancy=n.差異
discretion=n.謹慎,守口如瓶
discursive=adj.不著邊際的,散漫的
disdain=v.n.輕蔑
disembark=v.下船或下飛機,上岸
disfranchise=v.剝奪公民權
disgorge=v.嘔吐,被迫交出...
disgruntled=adj.不滿的
dishearten=v.使...灰心
disheveled=adj.(指毛髮或外貌)淩亂的
disinter=v.挖出
dislocate=v.使脫臼
dislodge=v.移去;取出
dismal=adj.悲傷的,陰沉的
dismantle=v.拆除
dismember=v.肢解,瓜分
disparage=v.輕視,貶抑
disparate=adj.迥然不同的
dispatch=v.n.派遣
dispel=v.驅散,消除
disperse=v.消散,驅散
dispirited=adj.沮喪的
disport=v.玩耍,娛樂
disposition=n.性情,安排
disquiet=v.n.使不安
disquisition=n.專題論文
dissemble=v.掩飾
disseminate=v.散佈,傳播
dissident=n.持異議者
dissimulate=v.掩飾
dissipate=v.驅散,浪費
dissolute=adj.放蕩的,無節制的
dissonance=n .分歧,異議
dissonant=adj.不和諧的,刺耳的
distrait=adj.心不在焉的
distraught=adj.心煩意亂的
distress=n.痛苦,悲痛
diurnal=adj.白天的
divagate=v.流浪,漫遊
diverge=v.(意見)分歧,分開
diversion=n.偏離,消遣
divest=v.剝奪
divulge=v.洩露
docile=adj.馴服的
doctrinaire=adj.n.空談理論的(人)
dodder=v.(因年老或體弱)步履不穩
dogmatic=adj.教條的,獨斷的
doldrums=n.精神不振
doleful=adj.憂愁的,消沉的
dolorous=adj.悲傷的
domesticate=v.馴養
domicile=n.住處,住所
doodle=v.胡寫,亂畫
dotage=n.老年(糊塗)
dote=v.溺愛
doughty=adj.勇敢的
dowdy=adj.穿著破爛的
downcast=adj.意志消沉的
dowry=n.嫁妝
draconian=adj.嚴厲的
drastic=adj.激烈的
dreary=adj.陰沉的;憂鬱的
dredge=v.挖掘,疏通
drench=v.使濕透
drivel=n.胡說八道;v.淌口水
drudgery=n.苦工
dubious=adj.可疑的
ductility=n.延展性
dulcet=adj.愉快的,悅耳的
dumbfound=v.使...驚訝
dupe=v.欺騙,n.傻子
duplicate=v.複製;adj.完全一樣的,複製的
duplicitous=adj.雙面的
duplicity=n.欺騙,口是心非
durance=n.監禁
duress=n.脅迫,監禁
dwindle=v.變小
dyslexia=n.閱讀障礙
dyspepsia=n.消化不良
ear-splitting=adj.震耳欲聾的
eavesdrop=v.竊聽
ebullient=adj.熱情洋溢的
eccentric=adj.n.古怪的(人)
eclat=n.成功,榮耀
eclectic=adj.折衷的
eclipse=n.日蝕,月蝕;v.黯然失色
ecstatic=adj.狂喜的
eddy=n.v.(起)漩渦
edify=v.教化
eerie=adj.可怕的;怪異的
efface=v.擦掉,抹去
effeminate=adj.柔弱的
effervesce=v.冒泡,活躍而興奮
effete=adj.衰弱的;喪失權力的
efficacious=adj.有效的
effigy=n.雕像,肖像
effrontery=n.厚顏無恥
effulgent=adj.光輝燦爛的
egocentric=adj.以自我為中心的
egregious=adj.異乎尋常的
elapse=v.(光陰)消逝
elastic=adj.有彈性的,靈活的
elate=v.使興奮
eleemosynary=adj.慈善的,施捨的
elegy=n.哀歌
elephantine=adj.笨拙的,龐大的
elicit=v.引出,探出
elixir=n.萬靈藥
ellipsis=n.省略
elocution=n.演說術
elucidate=v.闡明
elude=v.逃避
elusive=adj.難抓摸的
Elysian=adj.似天堂美的
emaciated=adj.憔悴,消瘦的
emanate=v.放出
emancipate=v.釋放,解放
embankment=n.河岸,路基
embargo=n.禁運令
embed=v.使嵌入
embellish=v.裝飾
embezzle=v.盜用
embodiment=n.化身,體現
embroider=v.刺繡
embroil=v.捲入糾紛
emend=v.訂正
eminent=adj.著名的,顯著的
emissary=n.密使;特使
emit=v.射出,散發
emollient=adj.有緩和作用的
emolument=n.報酬,薪水
empathy=n.同感
emphatic=adj.重視的,強調的
empirical=adj.經驗的,實證的
emulate=v.模仿
enamored=adj.珍愛的,喜愛的
enclosure=n.圈地,附件
encomium=n.讚頌,頌辭
encompass=v.包圍、圍繞
encroach=v.侵佔,蠶食
encumber=v.妨害,阻礙
endearing=adj.討人喜歡的
endow=v.資助
endue=v.賦予(才能)
enervate=v.使虛弱,使無力
engender=v.產生,引起
engrave=v.雕刻
engrossing=adj.引人入勝的
engulf=v.吞噬
enigmatic=adj.神秘的,難解的
enjoin=v.吩咐,命令
enlist=v.(使)入伍從軍,謀取
enmity=n.敵意
ennui=n.倦怠,厭倦
enormity=n.暴行
enrapture=v.使狂喜
ensconce=v.舒適地安坐在...,安置
ensemble=n.整體,劇團
enshrine=v.把...奉為神聖,珍藏
ensue=v.接著發生
entail=v.需要
enthrall=v.迷惑
entice=v.誘惑
entomology=n.昆蟲學
entrance=v.使著迷
entreat=v.懇求
entrenched=adj.根深蒂固的
entrepreneur=n.企業家
entwine=v.糾纏
enumerate=v.列舉
enunciate=v.闡明,清晰地發(音)
envisage=v.想像,設想
enzyme=n.酵素
ephemeral=adj.短暫的
epicure=n.美食家
epidemic=adj.傳染性的
epigram=n.警句
epigraph=n.刻文,碑文
episodic=adj.插曲多的,情節不連貫的
epithet=n.綽號,稱號
epitomize=v.作為...的縮影,寫...的梗概
epoch=n.紀元;時代
equable=adj.平靜的
equanimity=n.鎮定,沉著
equilibrium=n.平衡
equitable=adj.公正的
equivocate=v.模棱兩可地說
eradicate=v.根除
ergonomic=adj.人體工學的
erratic=adj.不穩定的,古怪的
erroneous=adj.錯誤的
erstwhile=adj.從前的
erudite=adj.博學的
escapade=n.惡作劇
eschew=v.避開
esoteric=adj.神秘的,深奧的
espionage=n.間諜活動
espouse=v.支持,擁護
esprit de corps=n.[法]團體精神
estrange=v.使疏遠
eternal=adj.永遠的
ethereal=adj.輕巧的;超凡的
etymology=n.詞源學
eugenic=adj.優生(學)的
eulogize=v.稱讚
euphemism=n.委婉語
euphonious=adj.悅耳的
euphoria=n.幸福愉快感
euthanasia=n.安樂死
evanescent=adj.短暫的
evaporate=v.(使某物)蒸發掉
evict=v.驅逐
evince=v.表明,表示
evocative=adj.引起(愉快)回憶的
evoke=v.引起,喚起
exacerbate=v.加重,惡化,激怒
exacting=adj.苛求的
exasperate=v.激怒
excavate=v.挖掘
exceptionable=adj.會引起反對的
exceptional=adj.罕見的,傑出的
excerpt=n.v.摘錄
excise=v.切除,刪去
exclaim=v.驚叫,呼喊
excoriate=v.嚴厲批評
excruciating=adj.極痛苦的
exculpate=v.無罪釋放
execrable=adj.糟透的;惡劣的
execrate=v.n.痛罵,憎恨
exegesis=n.說明
exemplary=adj.可作楷模的
exempt=v.免除
exhilarate=v.使高興
exhort=v.力勸,勉勵
exhume=v.掘出
exigency=n.緊急狀況
exiguous=adj.稀少的,細微的
exodus=n.大批移出
exonerate=v.證明無罪
exorbitant=adj.過分的,過度的
exorcise=v.驅魔,忘掉
expatiate=v.詳述
expatriate=v.逐出國外
expediency=n.權宜之計
expedite=v.加速,促進
expenditure=n.消耗,支出
expiate=v.贖(罪);抵償
explicable=adj.可解釋的,可說明的
explicate=v.解釋,闡明
explicit=adj.清楚明確的
exponent=n.擁護者,指數
exposition=n.展覽,解釋
expostulate=v.反對,抗議,抱怨
expound=v.詳細說明
expropriate=v.充公;沒收
expunge=v.刪除,抹掉
expurgate=v.刪去(不當處)
extant=adj.現存的
extemporize=v.即席演說,當場做成
extenuate=v.掩飾,減輕
exterminate=v.消滅
extirpate=v.拔除,消滅
extol=v.讚美
extort=v.敲詐
extracurricular=adj.課外的
extradite=v.引渡回國
extraneous=adj.外來的;無關的
extrapolate=v.推斷
extravagance=n.奢侈,揮霍
extricate=v.使解脫
extrinsic=adj.外部的
extrude=v.擠出
exuberant=adj.茂盛的,豐富的
exult=v.歡騰,喜悅
fabricate=v.捏造,組裝
facade=n.(建築物)正面
facetious=adj.滑稽的
facile=adj.易做到的
factitious=adj.人為的
factotum=n.打雜的人
fallacious=adj.欺騙的;謬誤的
fallacy=n.謬誤
fallow=adj.休耕的
falter=v.猶豫,蹣跚
famish=v.使饑餓
fanatic=adj.狂熱的;n.狂熱者
fanfare=n.大張旗鼓宣揚,熱議
fastidious=adj.難取悅的,挑剔的
fathom=v.理解,測量水深
fatuous=adj.昏庸的
fauna=n.(某一地區的)動物群
faux pas=n.失態;失言;失禮
fawn=v.討好,奉承
fealty=n.效忠
febrile=adj.發燒的,狂熱的
feckless=adj.無力的,無精打采的
fecund=adj.肥沃的,多產的
feeble=adj.虛弱的
feign=v.假裝,冒充
felicitate=v.祝賀
felicitous=adj.恰如其分的
felicity=n.幸福
felony=n.重罪
feral=adj.野生的,兇猛的
ferment=v.發酵,煽動
ferocious=adj.兇猛的,殘暴的
ferret=v.搜索
fervent=adj.熱切的
fester=v.潰爛,化膿
festive=adj.慶祝的,歡樂的
fetid=adj.有惡臭的
fetish=n.盲目崇拜之物
fetter=n.腳鐐;v.束縛或阻礙
fiasco=n.慘敗
fiat=n.命令
fictitious=adj.虛構的
fidget=v.坐立不安
fiduciary=adj.信託的,信用的
fiendish=adj.極凶惡的,刁鑽的
figment=n.虛構的東西
figurehead=n.傀儡
figurine=n.小雕像
filch=v.偷
filibuster=v.阻礙議案
finale=n.終曲,結局
finesse=n.手段;策略
finicky=adj.過分挑剔的
firebrand=n.煽動鬧事者
firmament=n.天空
fiscal=adj.財政的
flabby=adj.(肌肉)鬆軟的;意志薄弱的
flaccid=adj.鬆弛的,軟弱的
flagellate=v.鞭打
flagitious=adj.凶惡的
flagrant=adj.罪惡昭彰的,明目張膽的
flamboyant=adj.愛炫耀的,奢華的
flatulence=n.腸胃脹氣
flaunt=v.招搖,炫耀
flay=v.嚴厲批評
fleece=v.欺騙
fleeting=adj.飛逝的;短暫的
flicker=v.閃動,閃爍,搖動
flinch=v.畏縮
flippant=adj.輕浮的
flora=n.(某地區或時代的)植物群
florescence=n.開花期
florid=adj.華麗的,紅潤的
flotsam=n.漂浮之殘骸
flounder=v.艱難地移動,猶豫
flout=v.輕蔑,嘲笑
fluctuate=v.波動,變化
fluke=n.僥倖
flummery=n.胡說,虛假恭維
fluorescent=adj.螢光的
fluster=v.n.慌張
foible=n.(性格上的)小缺點
foil=v.阻撓;n.箔,襯托
foist=v.把...強加於(某人)
folklore=n.民間傳說
folly=n.愚蠢
foment=v.熱敷,煽動
foolhardy=adj.有勇無謀的
foolproof=adj.極簡單的
footloose=adj.自由自在的
forage=v.搜尋,翻尋
foray=n.v.突襲
forbearance=n.自制
forebear=n.祖先
forebode=v.預示,預感
foreclose=v.排除...的可能性,阻止
forego=v.放棄,居先
forensic=adj.法庭的
foreshadow=v.預示
forestall=v.先發制人
forfeit=v.(因違規而)喪失
forgery=n.偽造(物)
forgo=v.放棄
forlorn=adj.被遺棄的,孤獨的
formidable=adj.可畏的
forswear=v.放棄
forte=n.長處
forthright=adj.直截了當的
fortify=v.加強
fortitude=n.堅忍不拔
fortress=n.堡壘
fortuitous=adj.偶然的
foster=v.培養,領養
fracas=n.喧嚷,吵鬧
fractious=adj.易怒的
frail=adj.虛弱的
frantic=adj.瘋狂的,狂亂的
fraternal=adj.兄弟的
fraud=n.欺詐
fraught=adj.充滿
freebooter=n.海盜
freelancer=n.自由作家
frenetic=adj.激動的
frenzy=n.極度激動的狀態
fresco=n.壁畫
freshet=n.洪水
fretful=adj.煩躁的
friction=n.摩擦
frigid=adj.寒冷的
frisk=v.搜查,歡躍
fritter=v.(在無意義上的小事上)浪費...
frivolous=adj.輕浮的
frolic=v.嬉戲
froward=adj.頑固的
frowzy=adj.邋遢的,骯髒的
frugal=adj.節約的
fugacious=adj.短暫的
fugitive=adj.n逃亡的(者)
fulminate=v.叱責
fulsome=adj.過分而虛偽的
fumble=v.摸索或處理
fumigate=v.煙燻消毒
funereal=adj.適於葬禮的,哀悼的
fungus=n.菌類
furbish=v.刷新
furlough=n.休假(許可)
furtive=adj.偷偷的
fusillade=n.齊射,連珠炮似的質問
fusty=adj.落伍的,發黴的
futile=adj.徒勞的
gabble=v.n.急促而不清楚地說
gadfly=n.討厭的人
gaffe=n.失禮,失態,失言
gaiety=n.歡樂,快活
gainsay=v.否認
gallant=adj.勇敢的,華麗的
gallop=v.(馬)奔馳
galvanize=v.激勵,用鋅鍍
gambit=n.為獲得優勢採取的第一步行動
gambol=v.跳躍,蹦跳
gamely=adv.勇敢地
garble=v.曲解
gargantuan=adj.巨大的
garish=adj.俗麗的
garland=n.(勝利和榮譽的象徵)花環
garment=n.衣服
garner=v.收集,貯藏某物
garrulous=adj.喋喋不休的
gastronomy=n.美食學
gauche=adj.不善交際的
gaunt=adj.憔悴的,骨瘦如柴的
genesis=n.創始,起源
genial=adj.和藹的,愉快的
genteel=adj.文雅的
genuflect=v.下跪
germane=adj.與...有關係的
germinate=v.發芽;發展
gerontocracy=n.老人政府
grapple=v.扭住,處理with
grasping=adj.貪婪的
gratis=adj.免費的
gratuitous=adj.不必要的
gratuity=n.小費,賞錢
greenhorn=n.初學者
gregarious=adj.群居的,愛社交的
grill=v.嚴厲質問
grimace=v.做鬼臉
gripe=v.抱怨
grisly=adj.恐怖的
grotesque=asj.怪誕的
grotto=n.穴
grouse=v.抱怨
grovel=v.爬行,卑躬屈膝
grudge=v.勉強地給或承認;n.忌恨
grueling=adj.繁重而累人的
gruesome=adj.討厭的;可怕的
gruff=adj.粗暴的,粗聲粗氣的
grumble=v.發牢騷
guffaw=v.大笑
guileless=adj.老實的
gullible=adj.易受騙的
gustatory=adj.味覺的
gusto=n.愛好
gusty=adj.有風的
guzzle=v.大吃大喝
gyrate=v.旋轉
habiliments=n.衣服
habituate=v.使習慣於
hackneyed=adj.陳腐的
haggard=adj.憔悴的
haggle=v.討價還價
halcyon=adj.平靜的,愉快的
hallmark=n.特點
hallow=v.成為神聖
hallucination=n.幻覺
halting=adj.猶豫的
hamper=v.妨礙
hangdog=adj.羞愧的
hanker=v.渴求
haphazard=adj.偶然的,無計劃的
hapless=adj.不幸的
harangue=n.長篇大論,斥責
harbinger=n.先驅;前兆
harp=v.喋喋不休地說
harrow=v.折磨;n.耙
hassle=v.煩擾;n.困難
haughty=adj.傲慢的
havoc=n.大破壞
hawker=n.沿街叫賣之小販
headlong=adj.急速的
headstrong=adj.固執的
hearsay=n.道聼塗説
heartrending=adj.令人心碎的
heckle=v.詰問,困擾
hectic=adj.興奮的,繁忙的
hector=v.欺凌,威嚇
hedonism=n.享樂主義
hegemony=n.霸權
heinous=adj.令人髮指的
heirloom=n.傳家寶
hemophilia=n.血友病
hemorrhage=n.大出血
henchman=n.忠實助手
henpecked=adj.懼內的
hepatitis=v.肝炎
herald=v.預示;n.先驅
herbivorous=adj.草食的
herculean=adj.力大無比的
heretic=n.持異端意見者
hermetic=adj.密封的,與世隔絕的
herpetology=n.爬蟲學
heterodox=adj.非正統的
heterogeneous=adj.不同的
heyday=n.全盛時期
hiatus=n.間斷,間隙
hibernate=v.冬眠
hidebound=adj.頑固的,迂腐的
hideous=adj.可怕的,醜陋的
hierarchy=n.等級制度
hieroglyphic=n.adj.象形文字(的)
hilarious=adj.充滿歡樂的
hindrance="n.妨礙,障礙
hinterland=n.內地
histrionic=adj.做作的;劇院的
hitherto=adv.迄今
hoarse=adj.沙啞的
hobble=v.蹣跚
hodgepodge=n.大雜燴
holocaust=n.大屠殺
homage=n.尊敬
homespun=adj.樸實的
homily=n.講道,說教
homogeneous=adj.同類的
hoodwink=v.欺騙
horology=n.鐘錶學
horrendous=adj.可怕的
hortatory=adj.鼓勵的
horticulture=n.園藝學
hover=v.盤旋飛翔,徘徊
hubbub=n.喧嘩
hubris=n.傲慢
huckster=n.叫賣的小販
humdrum=adj.單調的;乏味的
husbandry=n.養殖,種植,節儉使用
hustings=n.政見發表會
hydroelectric=adj.水力發電的
hydrophobia=n.恐水症,狂犬病
hygiene=n.衛生學,衛生
hyperbole=n.誇張法
hypertension=n.高血壓
hypnosis=n.催眠狀態
hypochondria=n.憂鬱症
hysterical=adj.發狂的
iconoclast=n.反對崇拜偶像者
idiosyncrasy=n.特殊癖好或行為
idyll=n.田園詩,愉快恬淡的情景
ignite=v.點燃
ignominious=adj.可恥的
illegitimate=adj.不合法的,私生的
illusory=adj.虛幻的
illustrious=adj.輝煌的,著名的
imbecile=n.蠢人
imbibe=v.飲
imbroglio=n.錯綜複雜的局面
imbue=v.使...充滿...,灌輸
immaculate="adj.完美的
immanent=adj.內在的
imminent=adj.即將發生的
immolate=v.宰殺...作祭品,犧牲
immure=v.監禁,限制(發展)
immutable=adj.不變的
impale=v.刺穿
impalpable=adj.觸摸不著的
impart=v.傳授,告知
impasse=n.僵局
impassive=adj.冷漠的
impeach=v.控告,彈劾
impeccable=adj.無懈可擊的
impecunious=adj.貧窮的
impede=v.妨礙
imperious=adj.傲慢的
impersonator=n.模仿者
impertinence=n.魯莽,不切題
imperturbable=adj.冷靜的
impetuous=adj.衝動的
impiety=n.不敬
impinge=v.有不良影響
implacable=adj.堅定的,無法改變的
implant=v.灌輸,植入
implicate=v.牽連,涉及
implore=v.懇求
impolitic=adj.不明智的
imponderable=adj.n.(重要性)無法衡量(的)
import=n.意義,重要性
importune=v.一再向某人要求
imposing=adj.壯麗的
impostor=n.騙子
impound=v.扣押,沒收
impoverish=v.使成赤貧
impregnable=adj.攻不破的
impugn=v.責難,抨擊
impuissance=n.無力,無能
impunity=n.不受刑罰
impute=v.歸咎於
inadvertent=adj.不注意的,疏忽的
inaugurate=v.創始,使正式就職,啟用
incapacitate=v.使無能
incarcerate=v.監禁
incendiary=adj.縱火的
incense=v.使憤怒
inception=n.開端
incessant=adj.不斷的
inchoate=adj.剛開始的
incinerate=v.焚燒
incisive=adj.銳利的,深刻的
inclement=adj.惡劣的(天氣)
incognito=adj.隱名埋姓的,化名的
incorrigible=adj.不能改正,不能改變的
increment=n.增加
incriminate=v.連累,牽連
incubation=n.潛伏期
inculcate=v.向某人灌輸
inculpate=v.牽連,控告
incumbent=n.在職者
incur=v.遭受,招致
indebted=adj.感激的
indelible=adj.不可磨滅的
indemnify=v.賠償
indict=v.控告,起訴
indigenous=adj.當地的;生而俱有的
indigent=adj.貧窮的
indignant=adj.憤慨的
indoctrinate=v.教導;灌輸
indolent=adj.懶惰的
indomitable=adj.不屈不撓的
indubitable=adj.無可懷疑的
induct=v.引導,入伍,使正式就任
inebriate=v.使醉;n.酒鬼
inedible=adj.不宜食用的
ineffable=adj.難以表達的
inerrancy=n.可靠性
inertia=n.惰性
inexorable=adj.說不動的;不可阻擋的
infatuated=adj.迷戀的
infernal=adj.地獄的,可惡的
infest=v.大批滋生
infiltrate=v.滲透
infinitesimal=adj.無限小的
infirm=adj.虛弱的
inflict=v.使(某人)遭受...
influx=n.湧進,匯集
infraction=n.違法,違背
infringe=v.侵犯,違反
infuriate=v.使(人)極為憤怒
ingenious=adj.聰明的,有創造力的
ingest=v.吞下
ingrained=adj.根深蒂固的
ingrate=n.忘恩負義的人
ingratiate=v.迎合,討好
inherent=adj.與生俱來的
inhibit=v.抑制
inimical=adj.不友善的
iniquitous=adj.極邪惡的;極不公正的
injunction=n.命令,禁止
inkling=n.略知;暗示
innocuous=adj.無害的;無毒的
innuendo=n.影射,諷刺
inoculate=v.預防注射
inquietude=n.不安
inroad=n.侵襲,侵入
insalubrious=adj.不利於健康的
insatiable=adj.不能滿足的
inscribe=v.銘刻
inscrutable=adj.不可知的,不可理解的
insidious=adj.陰險的,潛伏的
insinuate=v.暗示
insipid=adj.乏味的;無生氣的
insolent=adj.粗野的,無禮的
insolvent=adj.無力償還的
insomnia=n.失眠症
insouciant=adj.無憂無慮的
instantaneous=adj.立即的;瞬間發生的
instigate=v.煽動,促使發生
instill=v.逐漸灌輸
insubordinate=adj.不服從的
insular=adj.心胸偏狹的
insulate=v.使絕緣,隔熱,隔音
insurgent=adj.暴動的
insurrection=n.造反,叛亂
intercede=v.調停,仲裁
interdict=v.禁止;n.禁令
interdisciplinary=adj.跨學科的
interim=adj.n.過渡時期(的)
interlocutor=n.對話者
interloper=n.闖入者
interlude=n.(劇間)休息
interminable=adj.無盡頭的
intermingle=v.混合,摻雜
intermittent=adj.斷斷續續的
interplay=v.n.相互影響
interpolate=v.竄改,插入(文字)
interrogate=v.審問
intersperse=v.散佈;點綴
intertwine=v.纏結
intervene=v.干預,調停
intimidate=v.恐嚇
intoxicate=v.使陶醉
intractable=adj.倔強的
intransigent=adj.不妥協的
intravenous=adj.靜脈內的
intrepid=adj.無畏的
intricate=adj.複雜的
intriguing=adj.引起極大興趣的
introspection=n.內省
intrude=v.闖入
inundate=v.淹沒;氾濫
inure=v.使習慣於
invariable=adj.永不變的
invective=n.猛烈抨擊;咒罵
inveigh=v.痛罵
inveigle=v.誘騙
inveterate=adj.積習難改的
invidious=adj.招嫉妒的,有害的
invigilate=v.監考
invigorate=v.使精力充沛
invincible=adj.不可征服的
inviting=adj.誘人的
invoke=v.祈求,借助,引起
iota=n.極小量
irascible=adj.易發怒的
irksome=adj.令人厭惡的
ironclad=adj.嚴格的,無法更改的
irredeemable=adj.不能收回,不能挽救的
irrefutable=adj.無可反駁的
irrevocable=adj.不可改變的
irrigate=v.灌溉
itinerary=n.行程表,路線
jaded=adj.疲憊的,厭倦的
jamboree=n.大聚會,慶祝會
jaundiced=adj.有偏見的
jaunty=adj.輕鬆愉快的
jejune=adj.沉悶乏味的,幼稚的
jeopardize=v.危害
jeremiad=n.悲痛
jettison=v.放棄,拒絕
jibe=v.嘲諷,嘲弄
jingoism=n.軍國,侵略主義
jocose=adj.開玩笑的,詼諧的
jocular=adj.滑稽的
jocund=adj.歡樂的
jollity=n.高興
jubilant=adj.喜悅的
judicious=adj.有判斷力的;明智的
juggernaut=n.不可抗拒的強大力量(或組織),重型貨車
junction=n.連接,匯合處
juncture=n.時刻,關頭,連結
junket=n.旅行
jurisdiction=n.司法權,審判權,管轄權
juxtapose=v.並排,並置
kaleidoscopic=adj.萬花筒般的,千變萬化的
kernel=n.(果)仁,要點,少許
killjoy=n.令人掃興的人
kinetic=adj.運動的
kismet=n.命運
kleptomania=n.盜竊癖
knack=n.技能,本領
knavery=n.詐欺
kudos=n.榮譽
labyrinth=n.迷宮
lacerate=v.撕裂,深深傷害
lachrymose=adj.愛哭的
lackadaisical=adj.無精打采的
lackey=n.卑躬屈膝的人
lackluster=adj.無光澤的;呆滯的
laconic=adj.簡潔的
laggard=n.行動遲緩的人;adj.緩慢的
lambaste=v.痛打;痛駡
lambent=adj.柔和發光的
lament=v.哀悼
lampoon=n.諷刺文章;v.諷刺
languid=adj.無精打采的
languor=n.衰弱,憔悴
larceny=n.偷竊
largesse=n.慷慨施捨
lassitude=n.無精打采
latency=n.潛伏期
latitude=n.緯度,言行自由
laudable=adj.值得稱讚的
lavish=v.浪費;adj.浪費的,慷慨的
leaven=v.使發酵,使變得有趣
lecherous=adj.好色的
leery=adj.猜疑的
leeward=adj.順風的
leeway=n.(可供活動的)餘地
legacy=n.遺產
legerdemain=n.戲法;障眼法
legible=adj.可辨認的
legitimate=adj.合法的
lenient=adj.寬大的
lesion=n.傷害
lethargic=adj.無精打采的
leverage=n.影響力,槓杆作用
levitate=v.(使)浮於空中
levity=n.輕浮
levy=n.稅款
lexicon=n.字典,詞典
liability=n.責任,累贅
liaison=n.聯絡
libellous=adj.誹謗的
libertine=n.放蕩不羈者
licentious=adj.放肆的,放蕩的
Lilliputian=adj.極小的;n.矮子
limber=adj.柔軟的;靈活的
limn=v.描寫,描繪
limpid=adj.清澈的
lineaments=n.特徵,輪廓
lionize=v.崇拜
liquidate=v.清償(債務)
lissome=adj.輕盈的,靈巧的
list=v.傾斜
listless=adj.沒精神的,懈怠的
litany=n.祈禱
lithe=adj.柔軟的
litigant=n.訴訟當事人
litigation=n.訴訟
loathsome=adj.令人作噁的
lockstep=n.亦步亦趨
locomotive=adj.運動的;n.火車頭
lofty=adj.崇高的,高聳的
logistics=n.後勤,物流
logjam=n.僵局
logomachy=n.對詞義的爭執
loiter=v.閒蕩
longevity=n.長壽
loom=v.隱現
loquacious=adj.多嘴的
lubricate=v.潤滑
lucrative=adj.有利可圖的
ludicrous=adj.荒唐可笑的
lugubrious=adj.陰鬱的
luminary=n.名人
luminous=adj.發亮的
lurid=adj.令人驚怕的
lurk=v.埋伏
luscious=adj.美味的
luxuriant=adj.繁茂的;肥沃的
macabre=adj.駭人的
Machiavellian=adj.狡猾的
machinations=n.詭計;陰謀
maelstrom=n.大漩渦;大混亂
maestro=n.音樂大師
magisterial=adj.有權威的
magnanimous=adj.寬宏大量的
magnate=n.巨頭,富豪
magnify=v.放大;讚美
magniloquent=adj.誇張的
maim=v.使殘廢
makeshift=adj.權宜的;臨時湊合的
maladroit=adj.不靈巧的
malaise=n.不舒服,抑鬱
malapropism=n.故意滑稽誤用文字
malediction=n.詛咒
malefactor=n.罪犯
malevolent=adj.惡意的
malfeasance=n.不法行為,瀆職
malicious=adj.惡意的
malign=v.誹謗;adj.惡毒的
malinger=v.裝病以逃避工作
malleable=adj.可鍛造的,可塑的
malodorous=adj.有臭味的
mammoth=adj.巨大的
manacle=n.手銬;v.約束
mangy=adj.破爛的,骯髒的
manifest=n.旅客名單;adj.顯然的;v.表明
manifold=adj.多種的
mannequin=n.人體模型
mannerism=n.習慣性動作
manumit=v.解放奴隸
manuscript=n.手稿
maraud=v.搶劫,掠奪
maritime=adj.海上的
marsh=n.沼澤地,濕地
martinet=n.嚴格執行紀律的人
martyr=n.烈士
masquerade=n.化裝舞會;v.偽裝
massacre=n.大屠殺
masticate=v.咀嚼
matador=n.鬥牛士
matrimony=n.結婚,婚姻
maudlin=adj.傷感的,易流淚的
maul=v.粗暴對待
maunder=v.嘮叨
mausoleum=n.陵墓
maverick=n.特立獨行的人
mawkish=adj.多愁善感的
maxim=n.箴言,格言
mayhem=n.大破壞,嚴重傷害罪
meager=adj.貧乏的
mealy-mouthed=adj.不坦率的,轉彎抹角的
meander=v.蜿蜒而流
mechanism=n.機制
meddlesome=adj.愛管閒事的
mediate=v.仲裁,調停
mediocre=adj.平庸的
megalomania=n.自大狂
melee=n.混亂,互毆
mellifluous=adj.流暢的,甜美的
memento=n.紀念品
menace=n.威脅
mendacity=n.虛假
mendicant=n.乞丐
menial=adj.(工作)乏味的,低賤的
mercantile=adj.商業的
mercenary=adj.唯利是圖的;n.傭兵
mercurial=adj.(情緒等)多變的
meretricious=adj.華而不實的
meritorious=adj.值得稱贊或獎勵的
mesmerize=v.對...催眠
metabolism=n.新陳代謝
mete=v.分配
meteoric=adj.流星的;曇花一現的
meticulous=adj.極注意細節的
metropolitan=adj.大都會的
mettlesome=adj.精神抖擻的
miasma=n.瘴氣,壞的氣氛或影響
milieu=n.社會環境;環境
minatory=adj.威脅的
minion=n.奴才
minuscule=adj.極小的
minute=adj.極小的
mirage=n.幻象
mirthful=adj.歡樂的
misadventure=n.不幸
misanthrope=n.憤世嫉俗者
misanthropy=n.厭惡人類,不願與人來往
miscellaneous=adj.混雜的,混合的
mischance=n.不幸
mischievous=adj.淘氣的
misconstrue=v.誤解,曲解
miscreant=n.惡棍
misdemeanor=n.輕罪
misgiving=n.疑慮;擔憂
mishap=n.不幸,災禍
misogamy=n.厭惡結婚
misogyny=n.厭惡女人
missive=n.信件
mitigate=v.減輕,緩和
mnemonics=n.記憶法
modicum=n.少量
modulate=v.調整
mogul=n.大亨,權勢之人
moiety=n.一半,一部分
molest=v.調戲,猥褻
mollify=v.安慰,安撫
momentary=adj.短暫的
momentous=adj.重要的
monetary=adj.錢的;貨幣的
monogamy=n.一夫一妻制
monolithic=adj.巨石的,巨大的
monotonous=adj.單調的
monumental=adj.巨大的,重要的
moot=adj.可辯論的
mope=v.抑鬱不樂
morass=n.沼澤,絕境
moratorium=n.暫停
morbid=adj.疾病的,病態的
mordant=adj.譏諷的,尖酸的
mores=n.風俗
moribund=adj.垂死的
morose=adj.脾氣壞的
mortify=v.使屈辱,使很尷尬
mosque=n.清真寺
motif=n.主題,主旨
motley=n.各式各樣的
mountebank=n.江湖騙子
muddle=v.混雜
muggy=adj.悶熱而潮濕的
mulct=v.對(某人)處以罰金,詐取
multifarious=adj.各式各樣的
mumble=v.含糊地說
mundane=adj.平凡的;世俗的
munificent=adj.慷慨的
murky=adj.黑暗的,陰鬱的
muster=v.召集,聚集
musty=adj.陳腐的,發黴的
mutation=n.突變;變異
mutilate=v.使傷殘,毀壞
mutineer=n.反叛者
mutinous=adj.暴動的,叛逆的
myopia=n.近視
myriad=n.adj.許多(的)
nadir=n.最低點
nascent=adj.初生的
natation=n.游泳
nauseate=v.使作嘔
nautical=adj.航海的,海上的
nebulous=adj.模糊不清的
necrology=n.死亡名單,訃告
nefarious=adj.邪惡的;不法的
nemesis=n.報應
neologism=n.新字
neophyte=n.初學者,新手
nepotism=n.裙帶關係
nestle=v.依偎,安頓下來
nettle=v.惹惱
neurosis=n.精神病
nexus=n.連結
nibble=v.輕咬,審慎地表示有意接受
nicety=n.細微的差別
niche=n.適合的或舒適的位置或職業
niggardly=adj.少量的,吝嗇的
nihilism=n.懷疑論
nimble=adj.敏捷靈活的
nirvana=n.涅槃
nitpick=v.吹毛求疵,挑剔
nocturnal=adj.夜晚的
noisome=adj.有害的,極令人不快的
nonchalant=adj.漠不關心的
nonentity=n.無重要之人或事
nonplus=v.使驚訝或困惑
nostrum=n.妙策,秘方藥
noxious=adj.有害的,有毒的
nuance=n.細微的差異
nugatory=adj.無用的
nullify=v.使無效
nuptial=adj.婚姻的
obdurate=adj.固執的;執拗的
obfuscate=v.使困惑
obituary=n.訃文
objurgate=v.斥責
oblation=n.供奉,祭品
oblique=adj.傾斜的
obliterate=v.塗去,刪除
oblivion=n.遺忘
obloquy=n.汙名
obnoxious=adj.令人不愉快的
obsequious=adj.諂媚的,奉承的
observance=n.遵守,慣例,慶祝
obsolete=adj.廢棄的
obstinate=adj.倔強的,頑固的
obstreperous=adj.愛吵嚷的,喧鬧的
obtrusive=adj.突出但難看的,強迫人的
obtuse=adj.鈍的,愚鈍的
obviate=v.消除,排除
occlude=v.使閉塞
occult=adj.秘密的
ocular=adj.眼的
odious=adj.可憎的
odoriferous=adj.芬芳的
offbeat=adj.不落俗套的
offhand=adj.未準備的,即席的
officious=adj.多管閒事的
offset=v.補償,抵消
olfactory=adj.嗅覺的
oligarchy=n.寡頭政治
ominous=adj.預兆的,不祥的
omnipotent=adj.全能的
omniscient=adj.全知的
omnivorous=adj.雜食的
onerous=adj.繁重的,費力的
onslaught=n.猛攻
ooze=v.慢慢流出
opalescent=adj.乳色的,多彩的
opaque=adj.不透明的
ophthalmic=adj.眼科的
opportune=adj.合適的
opprobrium=n.恥辱,咒罵
optimum=adj.最適宜的
opulent=adj.富裕的;充足的
oracular=adj.神諭的
ordain=v.制定
ordinance=n.法令
ordnance=n.大炮
ornate=adj.裝飾的,華麗的
ornithology=n.鳥類學
orotund=adj.宏亮的
orthography=n.正確拼字法
orthopedics=n.骨科醫學
oscillate=v.擺動;猶豫
osmosis=n.耳濡目染,滲透
ostensible=adj.表面上的,假稱的
ostentatious=adj.誇耀的,鋪張的
ostracize=v.放逐,排斥
otiose=adj.多餘的,無效的
outlandish=adj.古怪的
outstrip=v.超過
ovation=n.歡迎
overbearing=adj.專橫的,獨斷的
overriding=adj.最主要的,優先的
overstate=v.對...言過其實
overweening=adj.自負的
oxymoron=n.矛盾修飾法
pacify=v.平息;安撫
painstaking=adj.煞費苦心的
palatable=adj.美味的
palaver=n.麻煩,空話
palliate=v.減輕(痛苦)
pallid=adj.蒼白的,了無生趣
palpable=adj.可觸知的,明顯的
palpitate=v.(心臟)急速跳動
paltry=adj.微不足道的
panacea=n.萬靈藥
panache=n.炫耀自負
pandemonium=n.喧囂,大混亂
pander=v.迎合
panegyric=n.讚揚
panorama=n.全景
pantomime=n.默劇
parable=n.寓言
paradigm=n.範例,示範
parameter=n.參數
paramount=adj.最重要的
paraphernalia=n.設備
parch=v.極渴,烤焦
paregoric=n.鎮痛劑
pariah=n.被社會遺棄者
parley=n.談判,會談
parochial=adj.偏狹的,狹隘的,教區的
parody=v.滑稽地模仿
paroxysm=n.發作,突發
parry=v.避開
parsimonious=adj.小氣的
parvenu=n.暴發戶
passé=adj.過時的
pasteurize=v.以高熱殺菌
pastoral=adj.田園生活的
patchwork=n.拼湊的東西
patent=adj.公開的,明顯的
pathology=n.病理學
pathos=n.痛苦,感傷
patio=n.庭院,平臺
patrician=adj.n.貴族(的)
patrimony=n.遺產
paucity=n.小量,缺乏
pawn=v.典當;n.棋子
peccadillo=n.小過失
peculate=v.挪用(公款)
pecuniary=adj.金錢的
pedagogy=n.教育學
pedantic=adj.迂腐的,學究式的
pediatrician=n.小兒科醫生
pedigree=n.家譜,系譜,家世
peevish=adj.壞脾氣的
pejorative=adj.貶抑的
pell-mell=adv.adj.匆忙地,胡亂地
pellucid=adj.清晰的
penance=n.悔過,悔罪
penchant=n.愛好
pending=adj.即將發生的
penitent=adj.後悔的,懺悔的
penitentiary=n.監獄,感化院
pensive=adj.沉思的
penurious=adj.貧困的,吝嗇的
perambulate=v.漫步
percolate=v.過濾
percussion=n.衝擊,打擊(樂器)
perdition=n.滅亡
peregrination=n.旅行
peremptory=adj.專橫的
perennial=adj.四季不斷的,終年的
perfervid=adj.十分熱情的
perfidy=n.不忠,背叛
perfunctory=adj.草率的,敷衍的
peripheral=adj.不重要的,週邊的
perishable=adj.容易腐爛的
perjury=n.偽證
permeate=v.擴散;滲透
pernicious=adj.有害的
peroration=n.(演講的)結尾
perpetrate=v.犯罪
perpetual=adj.永久的
perquisite=n.額外補貼
persiflage=n.挖苦,嘲弄
persnickety=adj.挑剔的
personable=adj.英俊的
perspicacious=adj.獨具慧眼的
perspicuous=adj.清晰明白的
perspire=v.流汗
pertain=v.屬於;關於
pertinacious=adj.固執的
pertinent=adj.有關的
perturb=v.煩擾
peruse=v.細讀
pervasive=adj.遍及的
perverse=adj.墮落的,故意作對的
pervert=v.曲解,濫用
pester=v.糾纏,強求
pestilential=adj.疫病的
petrify=v.石化,嚇呆
petulant=adj.性急的,暴躁的
phantom=n.鬼怪,幽靈;adj.幻覺的
pharisaical=adj.虛偽的
philander=v.調情
philanthropist=n.慈善家
philatelist=n.集郵家
phlegmatic=adj.冷靜的,冷淡的
phony=adj.假的
photosynthesis=n.光合作用
piecemeal=adv.一件一件地;零碎地
pigment=n.色素,顏料
pilfer=v.偷竊
pillage=n.掠奪
pinnacle=n.尖塔;山峰
pinpoint=v.精確地找出或描述;adj.精確的
pious=adj.虔誠的
piquant=adj.辛辣的,開胃的
pique=n.生氣,激起
piscatorial=adj.魚的
pitfall=n.陷阱,圈套
pithy=adj.簡潔的
pivotal=adj.樞軸的,關鍵的
placate=v.撫慰
placid=adj.平靜的
plaintiff=n.原告
plaintive=adj.可憐的,傷心的
platitude=n.陳詞濫調
platonic=adj.純精神上的,柏拉圖(哲學)的
plaudit=v.喝彩,讚揚
plausible=adj.似是而非的
plebeian=adj.平民的
plenary=adj.全體出席的
plenitude=n.大量
pleonasm=n.冗詞,贅句
plethora=n.過量
plummet=v.突然下落
plutocracy=n.富豪政治
pneumonia=n.肺炎
poach=v.盜獵
poignant=adj.尖銳的,劇烈的
polyglot=n.adj.通曉多種語言的人
pompous=adj.自負的;浮誇的
pontifical=adj.主教的
populace=n.平民,大眾
portend=v.預兆,預示
posit=v.假定
posterity=n.後代,子孫
posthaste=adv.儘快地
posthumous=adj.死後的
postulate=v.假定
potable=adj.適於飲用的
potency=n.力量,影響力,效力
pragmatic=adj.務實的
prattle=v.閒聊
precarious=adj.危險的
precedent=n.前例
precept=n.規範,箴言
precipitate=v.加速,促進;adj.倉促的
precipitous=adj.陡立的,急躁的
precis=n.摘要,大綱
preclude=v.避免,排除
precocious=adj.早熟的
precursor=n.先驅
predecessor=n.前任,前輩
predicament=n.困境
predilection=n.愛好
predisposition=n.傾向
preeminent=adj.卓越的,傑出的
preempt=v.先發制人
preliminary=adj.初步的
prelude=n.前奏
premeditated=adj.預謀的
premiere=n.首次公演
premise=n.前提
premium=n.保險費;獎金;adj.優質的
premonition=n.預感,預兆
preoccupied=adj.心事重重的,出神的
preponderate=v.占優勢
preposterous=adj.荒謬的
prerequisite=n.先決條件
prerogative=n.特權
presage=v.預示
prescient=adj.有先見之明的
presentiment=n.預感
preside=v.主持
prestigious=adj.有名望的
presumption=n.假定
pretentious=adj.自負的,做作的,誇耀的
pretext=n.藉口
prevalent=adj.普遍的
prevaricate=v.說謊,支吾
primitive=adj.原始的,簡單的
privation=n.缺乏
privy=adj.隱密的
probation=n.試驗,緩刑,試用期
probity=n.正直,剛正
proceeds=n.收入
proclivity=n.傾向
procrastinate=v.拖延
procure=v.取得
prodigal=adj.揮霍的;n.揮霍者
prodigious=adj.巨大的,驚人的
profane=v.褻瀆;adj.世俗的
proffer=v.提供,貢獻
profligate=adj.揮霍的
profound=adj.深切的,知識淵博的
profuse=adj.大量的
progenitor=n.祖先
prohibitive=adj.禁止的,價格極貴的
proliferate=v.激增
prolific=adj.多產的
prolix=adj.囉嗦的,冗長的
promenade=v.散步
promulgate=v.宣揚,公布
pronounced=adj.顯著的
propagate=v.繁殖
propensity=n.傾向,習性
prophecy=n.預言
prophylactic=adj.預防性的
propinquity=n.接近,親屬
propitiate=v.撫慰,討好
propitious=adj.吉祥順利的
propound=v.提議
prorogue=v.休會
prosaic=adj.單調乏味的,散文的
proscribe=v.禁止
prostrate=adj.俯臥的
protean=adj.變化多端的
protégé=n.被保護者,門徒
prototype=n.原型
protract=v.延長,拖長
protrude=v.突出
provenance=n.出處,起源
provident=adj.深謀遠慮的
provincial=adj.偏狹的,省的
provisional=adj.暫時的
proviso=n.但書,附帶條件
prowess=n.非凡的才能,英勇
proximity=n.接近,附近
prudence=n.謹慎,小心
pseudonym=n.假名,筆名
psychiatrist=n.精神科醫生
psychopathic=adj.患精神病的
puerile=adj.幼稚的;兒童的
puffery=n.吹噓,吹捧
pugnacious=adj.好鬥的
pulchritude=n.美麗
pulverize=v.壓成細粉,徹底擊敗
punctilious=adj.拘泥細節的
pundit=n.博學者
pungent=adj.刺鼻的,尖銳的
purge=v.使清淨
purloin=v.偷竊
purvey=v.(大量)供給
purview=n.範圍
pusillanimous=adj.膽小的
putative=adj.推定的,假定的
putrid=adj.腐爛的
pyromania=n.放火癖
quack=n.騙子,庸醫
quaff=v.大口喝
quagmire=n.沼澤地;困境
quail=v.畏懼
qualm=n.疑慮
quandary=n.困惑;窘況
quantum=n.量子
quash=v.撤銷,鎮壓
quench=v.撲滅,解渴
querulous=adj.多牢騷的
quibble=v.推託
quid pro quo=n.補償物;交換物
quidnunc=n.愛打聽別人隱私的人
quiescent=adj.靜止的
quintessence=n.精華,典範
quip=n.俏皮話
quisling=n.賣國賊
quixotic=adj.不切實際的,空想的
quorum=n.法定人數
quotidian=adj.平常的,普通的
rabble=n.烏合之眾
rabid=adj.激烈的,患狂犬病的
raconteur=n.善於講故事的人
ragamuffin=n.衣衫襤褸的人
rail=v.抱怨
raillery=n.善意的嘲弄
raiment=n.衣服
ramble=n.v.漫步
ramify=v.分枝,縱橫交錯
rampage=v.狂暴地亂沖亂闖
rampant=adj.猖獗的
ramshackle=adj.搖搖欲墜的
rancid=adj.惡臭的
rancor=n.深仇,怨恨
rankle=v.使怒,發炎
rapacious=adj.強奪的,貪婪的
rapport=n.融洽和諧的關係
rapture=v.欣喜若狂
rarefy=v.使稀薄
raspy=adj.刺耳的
ration=v.n.實行定量配給
raucous=adj.(聲音)沙啞的
ravage=v.摧毀
ravenous=adj.貪婪的,餓極的
ravish=v.使陶醉,搶奪
reactionary=n.保守分子
realm=n.領域,範圍
rebate=n.減少,折扣
rebuff=v.冷酷拒絕
rebuke=v.譴責
recalcitrant=adj.頑抗的
recant=v.撤回
recapitulate=v.重述,概述
recede=v.撤回
recidivism=n.累犯
reciprocal=adj.互惠的
reclaim=v.改造,開墾
recline=v.向後倚靠或躺
reclusive=adj.隱居的
recoil=v.退縮
recollection=n.回想,回憶
recompense=v.n.報償
recondite=adj.深奧的
reconnaissance=n.偵察
recount=v.敘述
recourse=n.求助,依靠
recreant=n.懦夫
recriminate=v.反責,反控
rectify=v.改正,調正
recumbent=adj.側臥的
recuperate=v.恢復(健康)
redeem=v.贖回,買回
redemption=n.贖回,救贖
redolent=adj.芬芳的
redoubtable=adj.令人敬畏的
redress=n.修正,補償
refection=n.點心
refractory=adj.倔強的,難治的
refrain=v.抑制
refulgent=adj.輝煌的,燦爛的
refurbish=v.刷新,擦亮
refute=v.駁斥
regale=v.使某人快樂,款待
regime=n.政權
regimen=n.養生法
rehabilitate=v.使康復,使恢復(正常生活)
reimburse=v.償還
reincarnate=v.化生,轉生
reinstate=v.重新恢複職位,復原
reiterate=v.重申
rejoice=v.喜歡,高興
rejoinder=n.回答
relapse=n.v.舊病復發,故態復萌
relate=v.講述
relegate=v.貶職
relentless=adj.無情的,殘酷的
relevant=adj.中肯的,相關的
relinquish=v.放棄
relish=v.享受(某事物)
reminisce=v.回憶
remiss=adj.粗心的
remission=n.緩解期,寬恕
remit=v.寬恕,匯款
remonstrate=v.抗議
remorse=n.懊悔
remunerate=v.酬報某人
remunerative=adj.給酬報的
rendezvous=n.約會;約會地點
renegade=n.叛徒
renounce=v.放棄
reparable=adj.能補救的,可挽回的
repatriate=v.把...遣返回國
repeal=v.廢止,撤銷
repellent=adj.令人厭惡的;n.驅蟲劑
repent=v.懊悔,後悔
repertoire=n.全部節目,全部曲目
repine=v.不滿;埋怨
replenish=v.補充
replete=adj.充滿的
repose=v.安息,座落,基於
repository=n.倉庫
reprehend=v.譴責
repress=v.抑制,鎮壓
reprieve=v.n.緩刑
reprimand=v.訓誡,譴責
reprisal=n.報復
reproach=v.n.責備
reprobate=n.墮落者,惡棍
reproof=n.譴責,非難
repudiate=v.與(某人)斷絕來往,拒絕償付
repugnance=n.反感
repulsion=n.反駁,拒絕,嫌惡
reputed=adj.一般認為的,有名望的
requisition=n.正式請求;v.徵用
requite=v.報答
rescind=v.廢除,撤消
residual=adj.剩餘的
resigned=adj.順從的
resilient=adj.有彈性的
resonant=adj.洪亮的
resound=v.回蕩著聲音
resourceful=adj.足智多謀的
respite=n.休息;中止
resplendent=adj.華麗的,輝煌的
restitution=n.恢復
restive=adj.焦躁不安的
restorative=adj.有助於恢複健康的
restrain=v.克制,抑制
resurgent=adj.復興的
resuscitate=v.使甦醒
retaliate=v.報復
retention=n.保留
reticent=adj.沉默不語的
retinue=n.侍從
retiring=adj.含蓄的
retort=v.反駁
retrench=v.節省;削減費用
retribution=n.報應,懲罰
retrieve=v.尋回
retroactive=adj.溯及既往的
retrogress=v.倒退,退化
retrospect=n.回顧
revelry=n.狂歡
reverberate=v.發出回聲
revere=v.尊敬
reverie=n.白日夢
revile=v.辱罵
revoke=v.取消,撤回
revolt=v.n.叛亂,造反
revulsion=n.憎惡
rhapsodize=v.狂熱地寫(或說)
ribald=adj.粗俗詼諧的
rickety=adj.不牢靠的,搖晃的
rider=n.附加條款
rile=v.激怒
risible=adj.滑稽的
risque=adj.粗俗的,有傷風化的
robust=adj.強壯的
rococo=adj.華麗的
rollicking=adj.喧鬧而歡樂的
roster=n.名冊
rotund=adj.肥胖的
rowdy=adj.吵鬧的
rubicund=adj.(臉色)紅潤的
rucksack=n.(旅行等的)背包
rudimentary=adj.初步的,未充分發展的
rueful=adj.後悔的
ruffian=n.惡棍
ruminant=adj.反芻的,沉思的
rummage=v.搜索
rupture=n.v.破裂,斷裂
ruse=n.詭計,花招
rusticate=v.使變得質樸,住在鄉下,停學
sabbatical=n.(大學教師的)休假
sabotage=v.陰謀破壞
saccharine=adj.過甜的,過於殷勤的
sacrilege=n.褻瀆
sacrosanct=adj.神聖不可侵犯的
sagacious=adj.睿智的
salient=adj.顯著的
salubrious=adj.有益健康的
salutary=adj.有益的
salvage=v.n.搶救
sanctimonious=a.裝虔誠的
sanction=n.批准,制裁
sanctuary=n.聖堂,避難所
sangfroid=n.沉著
sanguine=adj.樂觀的
sanitary=adj.衛生的
sapid=adj.美味的
sapient=adj.有智慧的
sardonic=adj.嘲笑的
sartorial=adj.有關裁縫的
satiate=v.使充分滿足
satiety=n.滿足;飽足
saturate=v.使飽和
saturnine=adj.憂鬱的,陰沉的
saunter=v.n.閒逛
savoir-faire=n.應付自如的社交能力
savvy=n.實際能力,adj.有見識能幹的
scamper=v.蹦蹦跳跳
scapegoat=n.代罪羔羊
scathing=adj.嚴苛的
scavenge=v.撿破爛,以腐肉爲食
schematic=adj.綱要的
schism=n.分歧;分裂
scintillate=v.發出火花;閃爍
sciolism=n.一知半解
scoff=v.嘲笑,狼吞虎嚥
scorn=v.n.鄙視
scotch=v.遏止,阻止
scourge=n.苦難的根源
scramble=v.攀登;爭奪
scrawl=v.潦草地寫,亂塗
scrupulous=adj.謹慎小心的
scrutinize=v.仔細或徹底檢查
scurrilous=adj.辱罵的
scurry=v.快步走
scuttle=v.疾走,鑿沈,阻撓
sebaceous=adj.脂肪的
seclude=v.隱居,使隔離
secrete=v.分泌,隱藏
sectarian=adj.偏狹的,宗派的
secular=adj.世俗的
sedate=adj.安詳的,給...服鎮靜劑;v.給...服鎮靜劑
sedentary=adj.久坐的
sediment=n.沉澱物
sedition=n.煽動叛亂
sedulous=adj.勤勉的
seemly=adj.適當的
segregate=v.隔離
seismic=adj.地震的
semblance=n.外貌;相似
seminal=adj.對未來有影響的,種子的
senile=adj.年老的
sententious=adj.簡潔的
sepulcher=n.墳墓
sequester=adj.幽靜的;v.扣押,使隔離
serendipity=n.無意中有所新奇發現
serene=adj.平靜的,安詳的
serpentine=n.蜿蜒的
serried=adj.擁擠的,密集的
servile=adj.奴隸的,屈從的
shambles=n.淩亂;雜亂
shimmer=v.閃爍
shoddy=adj.劣等的
shrewd=adj.精明的
shudder=v.發抖
shuffle=v.拖著腳走
shunt=v.轉向,把...轉至
shyster=n.奸詐的人(律師,政客)
sibylline=adj.預言性的
sidereal=adj.星的
sidesplitting=adj.令人捧腹大笑的
sidestep=v.迴避(某個話題)
siege=n.圍困;圍攻
sift=v.篩查
silhouette=n.剪影,輪廓
simile=n.明喻
simper=v.n.傻笑
sine qua non=n.必要條件
sinecure=n.閒差事
sinewy=adj.肌肉發達的
singularity=n.獨特
sinister=adj.險惡的;不吉祥的
sinuous=adj.曲折的
sketchy=adj.大略的
skimp=v.節約
skinflint=n.吝嗇鬼
skirmish=n.小衝突,爭執
skittish=adj.活潑頑皮的
skulduggery=n.欺騙,詭計
skulk=v.偷偷摸摸
slack=adj.懶散的;v.怠惰
slanderous=adj.誹謗的
slapdash=adj.草率的
slattern=n.邋遢的人
sleeper=n.爆冷門,臥鋪列車
sleight=n.巧妙的手法
slither=v.滑行
slothful=adj.懶惰的
slouch=v.沒精打采地坐,站,走
slough=v.脫皮
slovenly=adj.邋遢的
sluggard=n.懶人
sluggish=adj.行動遲鈍的
slumber=v.睡眠
smattering=n.一知半解
smear=v.弄髒,玷污
smirk=v.傻笑;得意的笑
smolder=v.悶燒
smother=v.使窒息
smudge=n.汙點;v.弄髒
snatch=v.強奪
snicker=v.竊笑
snobbish=adj.勢利眼的
snub=v.冷落
snuggle=v.依偎
sobriquet=n.綽號
sodden=adj.溼透的
sojourn=n.逗留,寄居
solace=n.安慰,慰藉
solicit=v.懇求
solidarity=n.團結,一致
soliloquy=n.自言自語
solitude=n.孤獨
somber=adj.憂傷的
somnolent=adj.想睡的,催眠的
sonorous=adj.宏亮的
soothe=v.撫慰
sophomoric=adj.幼稚的
soporific=adj.引起睡眠的
sorcery=n.巫術,魔法
sordid=adj.骯髒的
sovereignty=n.主權
spacious=adj.廣闊的
sparse=adj.稀少的,稀疏的
spartan=adj.斯巴達式的
spasmodic=adj.抽筋的,不持續的
spat=n.口角
spate=n.洪水,大量突發事件
spatial=adj.空間的
spawn=v.大量產生
specimen=n.樣品,標本
specious=adj.似是而非的
spectrum=n.光譜;範圍
speculate=v.思索,推測,投機
spendthrift=adj.n.揮金如土的(人)
sphinx-like=adj.神秘的
spineless=adj.沒骨氣的,懦弱的
splenetic=adj.易怒的
splice=v.接合
splurge=v.揮霍,炫耀
sporadic=adj.偶發的
sprawl=v.四肢攤開著坐﹑臥或倒下
sprightly=adj.愉快的,活潑的
sprout=v.萌芽
spruce=adj.整齊的
spurious=adj.假的
spurn=v.唾棄
squabble=n.v.爭吵
squadron=n.中隊,一群
squalid=adj.汙穢的;骯髒的
squander=v.浪費,揮霍
squat=adj.矮胖的;v.蹲
squeamish=adj.神經質的,易受驚的
squint=v.眯著眼睛,斜視
stagger=v.蹣跚,搖晃
stagnant=adj.停滯的
staid=adj.古板的,沉著的
stalemate=n.僵局
stalwart=adj.健壯的,忠實的
stammer=v.口吃
standstill=n.停頓;中止
star-crossed=adj.時運不濟的
staunch=v.止血;adj.可靠的
steadfast=adj.堅定的
stench=n.臭氣,惡臭
stentorian=adj.響亮的
sterile=adj.不育的,無效果的
stern=n.船尾;adj.嚴厲的
stickler=n.非常注重(某種行為)的人
stifle=v.使感到窒息
stigmatize=v.侮辱
stilted=adj.浮誇的
stint=n.工作進度表,限量提供
stipend=n.薪俸,津貼
stipulate=v.規定
stocky=adj.矮而強壯的
stoical=adj.不動感情的
stoke=v.給...添加燃料
stolid=adj.無動於衷的
stonewall=v.拖延議事
stowaway=n.偷渡客
strand=v.擱淺;n.縷,部分
stratagem=n.謀略,策略
strenuous=adj.費力的;精力充沛的
strew=v.散佈
stricture=n.嚴厲譴責
strident=adj.刺耳的
stringent=adj.嚴厲的,迫切的
stultify=v.使無效,使感覺遲鈍
stupefy=v.(使)茫然,嚇呆
stygian=adj.陰森的
stymie=v.妨礙
suave=adj.溫文的
subdue=v.征服;壓制;減輕
subjugate=v.征服,鎮壓
sublimate=v.(使)昇華
subliminal=adj.潛意識的
submissive=adj.恭順的
subpoena=n.(法律)傳票
subsequent=adj.隨後的
subservient=adj.阿諛的,屈從的
subsidiary=adj.輔助的;次要的
subsist=v.生存下去
substantiate=v.證實
subsume=v.包含,包容
subterfuge=n.詭計,託辭
subvert=v.顛覆,推翻
succinct=adj.簡潔的
succor=v.n.救助
succulent=adj.多汁的;n.多肉植物
suffrage=n.選舉權
suffuse=v.充滿
sullen=adj.脾氣壞的,陰鬱的
sultry=adj.悶熱的
summon=v.召見;召集
sumptuous=adj.奢侈的,華麗的
sundry=adj.各式各樣
superannuated=adj.年邁的
supercilious=adj.目中無人的
superfluous=adj.多餘的
superintend=v.監督
supernumerary=adj.n.多餘的人或物,臨時雇員,臨時演員
supersede=v.淘汰,取代
supine=adj.仰臥的
supplant=v.排擠,取代
supplement=v.n.補充
supplicate=v.懇求
supposition=n.假設
supremacy=n.至高無上
surfeit=n.(食物)過量,過度
surmise=n.v.推測
surmount=v.克服,戰勝
surreptitious=adj.鬼鬼祟祟的
surrogate=n.代理人,代替品
sustenance=n.營養
swagger=v.大搖大擺地走
swarthy=adj.黝黑的
sweltering=adj.酷熱的
swerve=v.突然改變方向
swill=v.痛飲
swindle=v.詐騙
swoon=v.昏倒,狂喜
sybarite=n.奢侈逸樂的人
sycophant=n.馬屁精
symbiosis=n.共生(關係)
synchronize=v.使同步
synopsis=n.摘要,概要
tacit=adj.心照不宣的
taciturn=adj.沉默寡言的
taint=v.玷污
talisman=n.護身符
tamper=v.篡改
tangential=adj.離題的
tangible=adj.真實的,可觸摸的
tantalize=v.逗弄
tantamount=adj.相等的
tantrum=n.脾氣發作(尤指兒童)
tariff=n.關稅
tarnish=v.n.玷汙
tattered=adj.破舊的
taunt=v.嘲弄
tautology=n.多餘之重複
tawdry=adj.俗麗的
taxonomy=n.分類
tectonic=adj.地殼構造的
tedious=adj.冗長的,無聊的
teetotal=adj.滴酒不沾的
temerity=n.魯莽
temperate=adj.有節制的,適度的
tempestuous=adj.騷動的,狂暴的
temporal=adj.時間的;世俗的
temporize=v.拖延
tenable=adj.(主張)站得住腳的
tenacious=adj.堅韌不拔的
tendentious=adj.有偏見的,倔強的
tenet=n.信念,信條
tentative=adj.嘗試的,暫定的
tenuous=adj.稀薄的,細的
tenure=n.任期
tepid=adj.微溫的
terra incognita=n.未發現的地域,(知識上的)未知領域
terrain=n.地勢,地形
terrestrial=adj.地球的;陸地的
testament=n.遺囑
testimony=n.證言,證明
testy=adj.暴躁的
theology=n.神學
therapeutic=adj.治療的
thespian=adj.戲劇的,演戲的
thrall=n.奴隸,束縛
threadbare=adj.穿舊的,陳舊的
throes=n.劇痛
throng=n.擁擠的人群
throttle=v.使窒息
thwart=v.阻撓
tightwad=n.小氣的人
timorous=adj.膽小的
tipple=v.酗酒;n.酒精飲料
tirade=n.譴責性講話
titillate=v.激發慾望,逗引
titter=v.偷笑
titular=adj.有名無實的,名義上的
toady=n.諂媚者;v.諂媚
topple=v.推翻,倒下
topsy-turvy=adj.亂七八糟的
torpid=adj.懶散的
torpor=n.不活躍,萎靡,蟄伏
torrential=adj.洪流的
torrid=adj.酷熱的,熱烈的
tortuous=adj.彎彎曲曲的
totalitarian=adj.極權主義的
tout=v.讚揚,兜售
towering=adj.高聳的
traduce=v.中傷,誹謗
trample=v.踐踏
trance=n.昏睡狀態
tranquil=adj.寧靜的
transcend=v.超越
transfuse=v.輸血
transgress=v.冒犯,違背
transient=adj.短暫的
translucent=adj.半透明的
transmute=v.變化
transparent=adj.透明的,明顯的
transpire=v.發生
transport=n.強烈的情感;v.使產生身臨其境的感覺
traumatic=adj.受創傷的
travail=n.勞苦
traverse=v.橫貫或穿越
treachery=n.背叛
trek=n.長途跋涉
tremulous=adj.發抖的
trenchant=adj.一針見血的
trepidation=n.驚恐
trespass=v.侵入
tribulation=n.苦難
tribunal=n.審理團;特別法庭
tribute=n.讚美,進貢
trickle=v.滴流
trite=adj.陳腐的
truancy=n.翹課
truculence=n.兇猛,殘暴
trudge=v.跋涉
truncate=v.截短
tumult=n.混亂
turbid=adj.混濁的
turbulence=n.亂流,動盪
turgid=adj.浮腫的,不易流動的,枯燥乏味的
turncoat=n.叛徒
turpitude=n.邪惡;惡劣
tutelage=n.監護,指導
tycoon=n.大亨
ubiquitous=adj.無所不在的
ulterior=adj.較遠的,不可告人的
umbrage=n.不快,憤怒
unanimous=adj.意見一致的
unassuming=adj.謙虛的
unbridled=adj.未受約束的
uncanny=adj.異乎尋常的
uncouth=adj.粗野的,無禮貌的
unctuous=adj.油腔滑調的
undaunted=adj.無畏的
undermine=v.破壞
underscore=v.強調
undulate=v.波動
unearthly=adj.怪異的
unfetter=v.釋放
unflappable=adj.臨危不亂的
unfledged=adj.不成熟的
ungainly=adj.笨拙的;難看的
unguent=n.藥膏
unilateral=adj.單方面的
unkempt=adj.不整潔的;淩亂的
unobtrusive=adj.不引人注目的
unprepossessing=adj.乏味的,沒有吸引力的
unravel=v.解開
unremitting=adj.不間斷的,不懈的
unruly=adj.任性的,不守規矩的
untenable=adj.站不住腳的
untoward=adj.不利的,事與願違的
unwieldy=adj.不便移動或操縱的,笨拙的
unwitting=adj.無意的
unwonted=adj.不尋常的
upbraid=v.斥責
upheaval=n.動亂,大變動
uphold=v.維護,支持
upshot=n.結局
upstart=n.暴發戶,突然發跡的人
urbane=adj.文雅的
urchin=n.頑皮的小孩
usurp=v.霸佔
usury=n.高利貸
utilitarian=adj.功利的,實用的
uxorious=adj.寵愛妻子的
vacillate=v.動搖不定,猶豫
vacuous=adj.無思想的,無智慧的
vagabond=n.流浪者
vagary=n.幻想,變幻無常的事件
vainglorious=adj.自負的,虛榮心強的
valediction=n.告別演說
valiant=adj.勇敢的
validate=v.具有法律效力,證實
valor=n.勇氣
vandalism=n.(對公物)惡意破壞
vanguard=n.先鋒,領導者
vanquish=v.征服
vantage=n.優勢
vapid=adj.無味的,無趣味的
variegated=adj.雜色的
vaunt=v.吹噓
vegetate=v.過枯燥的生活
vehement=adj.感情強烈的;熱情的
velocity=n.速度
venal=adj.貪贓枉法的
vendetta=n.世仇,宿怨
venerable=adj.可敬的
venial=adj.可原諒的
ventilate=v.使...通風
veracious=adj.真實的,誠實的
verbatim=adj.adv.逐字的(地)
verbiage=n.冗詞
verbose=adj.冗長的
verdant=adj.翠綠的
verisimilitude=n.貌似真實
vernacular=n.本地話
vernal=adj.春天的
vertex=n.頂點
vertigo=n.眩暈
verve=n.活力
vestige=n.遺跡;痕跡
viable=adj.可行的,能活的
vicarious=adj.設身處地的;間接感受到的
vicinity=n.附近
vicissitudes=n.變遷,人生沉浮
vigilant=adj.機警的,警惕的
vilify=v.辱駡,誹謗
vindicate=v.辯護,解釋,辯白
vindictive=a.報復的、懷恨的
virile=adj.有男子氣概的
virtuosity=n.精湛技巧
virulent=adj.致命的,劇毒的
viscid=adj.黏的
vitiate=v.損壞,變質
vitriolic=adj.刻薄的
vituperate=v.痛斥
vivacious=adj.活潑的,有生氣的
vivisection=n.活體解剖
vociferous=adj.喧嘩的
volatile=adj.揮發性的,不穩定的
voluble=adj健談的、口若懸河的
voluminous=adj.寬鬆的,長篇的
voracious=adj.狼吞虎嚥的,貪婪
votary=n.崇拜者,熱心支持者
vouch=v.擔保,證明
vouchsafe=v.告知,保證,提供
vulgar=adj.粗俗的
waffle=v.胡扯,嘮叨
waft=v.飄送,使飄蕩
waggish=adj.詼諧的,淘氣的
waive=v.放棄
wanderlust=n.旅遊慾
wane=v.n.衰退
wanton=adj.惡意的,肆無忌憚的
warble=v.鳥鳴,(尤指以高音)歌唱
warmonger=n.好戰者
watershed=n.分水嶺
waylay=v.埋伏
wean=v.(孩子)斷奶;戒掉
weasel=v.逃避
welter=n.雜亂的一堆東西
wheedle=v.(用花言巧語)哄騙
whet=v.刺激,磨利
whimsical=adj.古怪的,異想天開的
whirlpool=n.漩渦
wholesome=adj.有益於健康的
wicked=adj.缺德的,邪惡的
wiggle=v.扭動,蠕動
willowy=adj.苗條的
wince=v.(因疼痛而)皺眉蹙額
windfall=n.意外之財
winsome=adj.漂亮的
wistful=adj.發愁的,渴望的
witticism=n.幽默有智慧的評語
wizened=adj.皮膚乾而皺的
wobble=v.擺動,打顫
woeful=adj.悲傷的
wraith=n.鬼
wrangle=v.爭論,激辯
wrath=n.大怒
wreak=v.加害
wrest=v.奪取
writhe=v.扭曲
xenophobia=n.仇外,排外
zealot=n.狂熱分子
zenith=n.頂點
zephyr=n.微風
zigzag=v.n.彎彎曲曲地進行
