Intercom=對講機
Shoehorn=鞋拔
Peephole=貓眼
Folding umbrella=摺疊傘
Stereo system=立體音響
Speaker=喇叭
Cushion=坐墊
Throw pillow=抱枕
Remote control=遙控器
Potted planted=盆栽
Pillow=枕頭
Pillowcase=枕頭套
Comforter=棉被
Nightstand=床頭櫃
Mattress=床墊
Nightgown=女性睡衣；睡袍
Pajamas=睡衣褲
necklace=項鍊
scarf=圍巾
bracelet=手鍊
perfume=香水
nail polish=指甲油
toner=化妝水
face essence=精華液
moisturizer=乳液
powder=蜜粉
powder puff=粉撲
sponge=海綿
lip gloss=唇蜜
lip balm=護唇膏
blush=腮紅
nail clipper=指甲剪
eyebrow pencil=眉筆
eyeliner=眼線筆
mascara=睫毛膏
pre-makeup cream=隔離霜
facial mask=面膜
liquid foundation=粉底液
eye shadow=眼影
cleansing oil=卸妝油
lotion=化妝水
suit=西裝
tank top=無袖上衣
blouse=女用襯衫
shorts=短褲
necktie=領帶
cosmetics=化妝品
zipper=拉鏈
ribbon=緞帶
measuring tap=捲尺
thread=線
sewing=縫紉
knitting=打毛線
toy block=積木
sketchbook=畫本
crayon=蠟筆
bunk bed=上下舖的床
ladder=梯子
picture book=繪本
crib=嬰兒床
rattle=沙鈴
pacifier=奶嘴
A nursey=嬰兒房
bib=圍兜
diaper=尿布
formula=奶粉
baby bottle=奶瓶
baby food=副食品
wet wipe=濕紙巾
baby powder=嬰兒爽身粉
potty chair=嬰兒馬桶
baby carrier=背巾
edge protector/corner guard=防撞貼條
baby bathtub=嬰兒澡盆
playpen=嬰兒遊戲床
stuffed toy=絨毛玩偶
infant car seat=安全座椅
cradle=搖籃
stroller=嬰兒車
medicine patch=貼布
cold medicine=感冒藥
throat lozenge=喉糖
bandage=繃帶
stomach medicine=胃藥
medicine for constipation=便秘藥
eye drops=眼藥水
Band-aid=Ok繃
tweezers=平口鑷子
ointment=藥膏
medical tape=透氣膠布
gauze=紗布
Q-tip=棉花棒
thermometer=體溫計
surgical tweezers=尖嘴鑷子
antiseptic soloution=消毒藥水
bug spray=除蟲噴霧
surgical mask=口罩
scissors=剪刀
poster=海報
meal calender=月曆
desktop computer=桌上型電腦
printer=印表機
ballpoint pen=原子筆
tablet computer=平板電腦
bookshelf=書櫃
picture frame=相框
file folder=文件夾
saucepan=平底深鍋
pepper mill=胡椒研磨器
hot pad=隔熱墊
grated Parmesan cheese=帕瑪森起司粉
tongs=夾子
salt shaker=鹽罐
spaghetti=義大利麵
platter=大淺盤
risotto=燉飯
tray=托盤
kitchen fan=抽油煙機
spatula=鍋鏟
wok=炒菜鍋
frying pan=煎鍋
gas stove=瓦斯爐
oven=烤箱
oven mitts=隔熱手套
olives=橄欖
paper towel=廚房紙巾
olive oil=橄欖油
cooking oil=食用油
wooden spatula=木製鍋鏟
ladle=湯勺
can opener=開罐器
cutting board=砧板
canned food=罐頭
microwave oven=微波爐
dishwasher=洗碗機
cleaver=大菜刀
freezer=冷凍庫
refrigerator=冰箱
crisper drawer=蔬果保鮮室
tablecloth=桌布
parchment paper=烘培用紙
baking sheet=烘培淺盤
apron=圍裙
rolling pin=桿麵棍
sieve=篩網
mixing bowl=大盆子
mixer=攪拌器
sugar=砂糖
baking powder=發粉
flour=麵粉
kitchen scale=料理秤
tank=水箱
toilet paper=衛生紙
toilet control=操控器
toilet seat cover=馬桶蓋
handrail=扶手
trash can=垃圾桶
toilet seat warmer=馬桶暖座
bidet toilet seat=溫水洗淨便座
toilet seat=馬桶座
contour bath rug=馬桶踏墊
bathroom fan=抽風機
air freshener=除臭噴霧
hand soap=洗手乳
toilet brush=馬桶刷
toilet brush holder=馬桶刷座
plunger=馬桶吸盤
hand towel=擦手巾
showerhead=蓮蓬頭
shower=淋浴
shower door=淋浴門
bath handle=扶手
rubber duck=玩具小鴨
soap=肥皂
shower gel=沐浴乳
shampoo=洗髮精
conditioner=潤髮乳
bathtub=浴缸
antislip mat=止滑墊
mirror=鏡子
towel=毛巾
bathroom sink=洗臉台
tissue=面紙
stool=小板凳
bath towel=浴巾
blow-dryer=吹風機
shaving cream=刮鬍膏
towel holder=毛巾架
electric razor=電動刮鬍刀
mouthwash=漱口水
hairbrush=梳子
floss=牙線
toothbrush=牙刷
toothpaste=牙膏
dryer=烘衣機
washing machine=洗衣機
laundry basket=洗衣籃
faucet=水龍頭
sink=水槽
drain=排水孔
backyard=庭院
fence=圍牆
collar=項圈
watering can=灑水壺
flowerpot=花盆
garden shovel=園藝鏟子
lawn mower=割草機
hose=水管
garage=車庫
surfboard=衝浪板
rearview mirror=後照鏡
wetsuit=潛水衣
fishing pole=釣竿
bucket=水桶
rag=抹布
fire extinguisher=滅火器
tire=輪胎
pliers=老虎鉗
screwdriver=螺絲起子
saw=鋸子
drill=電鑽
hammer=槌子
helmet=安全帽
toolbox=工具箱
screw=螺絲釘
nail=釘子
utility knife=美工刀
