ability=n.能力,才幹
abroad=adv.往國外,到處,海外,廣泛,差得遠,心裡沒有譜
absence=n.不在,缺席,缺乏,沒有
absent=adj.不在的,缺席的,缺少的;vt.缺席
accept=vt.接受,認可,承擔,承兌;vi.同意,承認
active=adj.積極的,能起作用的,現行的,主動的,活動的,活躍的,活性的;n.主動語態,積極分子
addition=n.加,加起來,增加物,增加,加法
advance=n.前進,提昇,預付款;v.前進,提前,預付;adj.前面的,預先的；預付(款項)
affair=n.事務,事件,私事,戀愛事件,(尤指關係不長久的)風流韻事
aid=n.幫助,援助,幫助者,有幫助的事物;vt.資助,援助,幫助
aim=n.目標,目的,瞄準;v.對…瞄準,打算
aircraft=n.航行器
airline=n.定期航線
alarm=n.警報,驚慌,警告器;vt.恐嚇,警告
album=n.集郵本,照相簿,簽名紀念冊
alike=adj.相同的,相似的;adv.以同樣的方式,類似于
alive=adj.活著的,活潑的
almond=n.杏樹,杏仁,杏仁壯物
aloud=adv.大聲地
alphabet=n.字母表
although=連.雖然,儘管
altogether=adv.完全地,總而言之
amount=n.數量;vi.(to) 總計,等於
ancient=adj.遠古的,舊的
ankle=n.踝
anybody=代.任何人,重要人物
anyhow=adv.無論如何,總之
anyone=代.任何一個
anyplace=adv.任何地方
anytime=adv.任何時候,無論何時
anyway=adv.無論如何,總之
anywhere=adv.無論何處
apartment=n.<美>公寓住宅,單元住宅,房間
appearance=n.出現,露面,外貌,外觀
appetite=n.食慾,胃口,慾望,愛好
apply=vt.申請,應用;vi.申請,適用
apron=n.圍裙,外表或作用類似圍裙的東西,擋板,護坦
argue=vi.爭論,辯論;vt.說服
argument=n.爭論,辯論,論據,論點,(~ for,against)意見
arm=n.臂,臂狀物,衣袖,海灣,武器;vt.供給,提供,武裝,裝備;vi.武裝起來
armchair=n.扶手椅子
arrange=v.安排,排列,協商
arrangement=n.排列,安排
arrest=vt.逮捕,拘留,吸引;n.逮捕,拘留
arrive=vi.到達,抵達
arrow=n.箭,箭頭記號
article=n.文章,論文,物品,商品,項目,條款;v.清楚說出;adj.表達清晰的
artist=n.藝術家,畫家
asleep=adj.睡著的,睡熟的
assistant=n.助手,助教;adj.輔助的,助理的
attack=n.進攻,攻擊,(用語言)抨擊,批評,疾病發作,侵襲;vt.攻擊,抨擊,動手處理(某事);vi.攻擊
attend=vt.出席,參加,照顧,護理,注意;vi.專心,留意
attention=n.注意,關心,關注,注意力,(口令)立正!
avoid=vt.避免,消除
baby-sit=vi.擔任臨時保姆,照顧嬰兒
baby-sitter=n.代人臨時照看嬰孩者
backward=adv.adj.向後地(的),相反地(的),追溯,退步,由好變壞
backwards=adv.向後
bake=v.烘焙,烤,燒硬
bakery=n.麵包店
balcony=n.陽臺,包廂,(戲院)樓廳
bamboo=n.竹子
banker=n.銀行家
barbecue=n.吃烤燒肉的野餐
bark=n.樹皮,吠聲;v.吠,咆哮,剝樹皮
basement=n.地下室,牆腳
basic=n.基本,要素,基礎;adj.基本的,鹼性的;n.BASIC語言,基本高級語言
basis=n.基礎,基本,根據,主要成份(或要素),(認識論中的)基本原則或原理
battle=n.戰役(指大規模會戰),戰爭;vi.作戰,戰鬥,搏斗,鬥爭
bead=n.珠子,水珠
bean=n.豆,豆形果實
bear=n.熊;v.負擔,忍受,帶給,具有,擠,向
beard=n.鬍鬚
bedroom=n.臥室
beef=n.牛肉
beep=n.嗶嗶聲;v.嘟嘟響
beer=n.啤酒
beetle=n.甲蟲;vi.懸垂,突出
beg=v.請求,乞求
beginner=n.初學者
belief=n.信任,信心,信仰
believable=adj.可信的
belt=n.帶子,地帶
bench=n.長椅子
bend=v.彎曲,專心于,屈服;n.彎曲
besides=adv.此外;介.除…之外
bet=n.賭,打賭;v.賭,賭錢
beyond=介.在(到)…較遠的一邊,超過,那一邊;adv.在遠處;n.遠處
bill=n.帳單,鈔票,票據,清單,議案,法案,廣告;vt.用海報宣傳,把…列成表,給…開帳單
bind=v.綁,鑲邊,裝訂,凝固,約束
bitter=adj.苦的,痛苦的,懷恨的
blackboard=n.黑板
blank=adj.空白的,空著的,失色的,沒有表情的;n.空白,<美> 表格
blind=adj.瞎的,盲目的;vt.使失明,缺乏眼光或判斷力
bloody=adj.血腥的,嗜殺的,有血的,<英鄙>該死的,非常的
board=n.木板,(供特殊用途的)木板,甲板,膳食費用;vt.用板蓋上,包飯,提供膳食；(船與船)並行
boil=n.沸點,沸騰,癤子;v.煮沸,激動
bomb=n.炸彈;vt.投彈于,轟炸
bony=adj.多骨的,瘦骨嶙峋的
bookcase=n.書架,書櫃
borrow=v.借,借入,借用
boss=n.老闆,上司;vt.指揮
bother=vt.煩擾,打擾;vi.煩惱,操心;n.麻煩,煩擾;v.打擾
bottle=n.瓶子;vt.用瓶裝
bow=n.弓,樂弓,弓形,鞠躬,船首;v.鞠躬,彎腰
bowling=n.保齡球
brain=n.腦,頭腦
branch=n.枝,分枝,分部,分店,(學科)分科,部門,支流,支脈;v.出現分歧
brand=n.商標,牌子,烙印;vt.打火印,污辱
brick=n.磚,磚塊,磚形物(如茶磚,冰磚等),<口>心腸好的人
brief=n.摘要,大綱;adj.簡短的,短暫的;vt.摘要,(軍事)下達簡令
broad=adj.寬的,闊的,廣泛的,明朗的,露骨的,顯著的,主要的;adv.寬闊地;n.寬闊部份
broadcast=n.廣播,播音;v.播撒(種子),廣播；(無線電或電視)廣播；播送,播放
brow=n.眉毛,額,(面部)表情
brunch=n.早午餐
brush=n.刷子,毛刷,畫筆;vt.刷,撣,拂
bun=n.小圓麵包,曲卷(或結)狀的頭髮
bundle=n.捆,束,包;v.捆扎
burger=n.碎肉夾餅,各種夾餅
burn=v.燒,燒焦,點(燈),使感覺燒熱;n.燒傷,灼傷
burst=v.爆裂,炸破,急于,爆發;n.突然破裂,爆發,脈沖
business=n.商業,買賣,交易,生意,事情,事物,營業,商行
button=n.鈕釦,按鈕;v.扣住,扣緊
cabbage=n.甘藍,捲心菜
cable=n.電纜,海底電報,纜,索;v.打(海底)電報
cafe=n.咖啡館,小餐館
cafeteria=n.自助餐廳
calendar=n.日曆,曆法
calm=adj.(天氣﹑海洋等)靜的,平靜的,鎮靜的,沉著的;v.(使)平靜,(使)鎮定,平息
cancel=vt.取消,刪去
cancer=n.癌,毒瘤
candle=n.蠟燭;vt.對著光檢查
captain=n.隊長,首領,船長,機長,(空軍,海軍)上校,(陸軍)上尉;v.指揮,統帥
carpet=n.地毯
carrot=n.胡蘿蔔
cart=n.大車,手推車;vt.用車裝載
cartoon=n.(報刊上的)政治性漫畫,諷刺畫,卡通畫,漫畫(常有解說詞);v.畫漫畫;n.卡通片,動畫片
cash=n.現金;vt.兌現
cassette=n.盒子,盒式磁帶
castle=n.城堡
catsup=n.醬(如蕃茄醬之類)
cave=n.洞穴,窯洞;vi.凹陷,投降;vt.挖洞,使凹陷
ceiling=n.天花板,最高限度
cell=n.單元,細胞,蜂房,(尤指監獄或寺院的)單人房間,電池
central=adj.中心的,中央的,重要的,主要的,中樞的,走中間道路的;n.<美>電話總機
century=n.世紀,百年,百個,板球中的一百分,百元(鈔票)
cereal=n.穀類食品,穀類
chalk=n.粉筆,白堊;vt.用粉筆寫,和以白堊
change=n.改變,變化,轉變,找回的零錢,找頭,輔幣;vt.改變,變革,改造,兌換
character=n.(事物的)特性,性質,特徵(的總和),(人的)品質,字符,性格,特徵,人物;vt.寫,刻,印,使具有特徵
charge=n.負荷,電荷,費用,主管,掌管,充電,充氣,裝料;v.裝滿,控訴,責令,告誡,指示,加罪于,衝鋒
cheap=adj.便宜的,不值錢的
cheat=n.欺騙,騙子;v.欺騙,騙取
chemical=adj.化學的;n.化學製品,化學藥品;n.化學藥品
chess=n.國際像棋
childish=adj.孩子氣的,幼稚的
childlike=adj.孩子似的,天真爛漫的
chin=n.下巴,下顎
chocolate=n.巧克力,巧克力色
choice=n.選擇,抉擇,精選品,選擇機會,選擇權;adj.精選的,上等的,挑三揀四的,可選的,寵愛的,愛惜的
choose=v.選擇,選定
chopstick=(中國的)筷子
chopsticks=n.筷子
circle=n.圓週,圓形物,派系,循環;v.圍,環繞；盤旋
citizen=n.市民,公民
claim=n.(根據權利提出)要求,要求權,主張,要求而得到的東西;vt.(根據權利)要求,認領,聲稱,主張,需要
clap=n.拍手聲,霹靂聲;v.鼓掌,輕拍
classic=n.傑作,名著;adj.第一流的
claw=n.爪,腳爪;v.抓
clay=n.粘土,泥土,肉體,人體,似黏土的東西,陶土制的煙斗
cleaner=n.清潔工人,清潔器
clerk=n.職員,辦事員,<美> 店員
clever=adj.機靈的,聰明的
climate=n.氣候,風土,思潮
closet=n.壁櫥,儲藏室,廁所;adj.關起門來的;vt.關入私室密談
cloth=n.布,織物,衣料
clothe=vt.給…穿衣,覆蓋
clothes=n.衣服,被褥,各種衣服,<美俚>家醜
clothing=n.衣服
cloudy=adj.多雲的,陰天的,陰沉
clown=n.小醜,粗魯愚蠢的人
club=n.俱樂部,夜總會,社,棍棒,(高爾夫球等的)球棒,(扑克牌)梅花;vt.棍打,協作,聯合,把…當棍棒用
coach=n.四輪大馬車,長途汽車,教練;v.訓練,指導
coal=n.煤;v.加煤
cock=n.公雞,雄鳥,頭目,(水)龍頭,<俚>陰莖;vt.使聳立,使豎起,堆成錐形;vi.大搖大擺地走,翹起
cockroach=n.蟑螂
coin=n.硬幣;vt.鑄造(硬幣)
collect=v.收集,聚集,集中,蒐集;adj.由收件人付款的;adv.由收件人付款地
colorful=adj.華美的,色彩的,有趣的
comb=n.梳子,梳,雞冠,蜂巢;vi.梳(發),搜索
comfortable=adj.舒適的
company=n.公司,陪伴,(一)群,(一)隊,(一)伙,連,連隊
compare=v.比較,相比,比喻;n.比較
complain=v.抱怨,悲嘆,控訴
complete=adj.全部的,完全的,完成的;vt.完成,使完善
computer=n.計算機,電腦
confirm=vt.確定,批准,使鞏固,使有效;v.確認,(基督教中)給…行按手禮
conflict=n.鬥爭,衝突;vi.抵觸,衝突
Confucius=n.孔子(公元前551--479年,中國春秋末期思想家﹑政治家﹑教育家,儒家的創始者)
congratulation=n.祝詞,賀辭
consider=vt.考慮,照顧,認為
contact=n.接觸,聯繫;vt.接觸,聯繫
contain=vt.包含,容納,容忍;vi.自制;v.牽制(敵軍);v.可被…除盡
control=n.控制,支配,管理,調節,抑制,控制器,調節裝置;vt.控制,支配,管理(物價等),操縱,抑制
controller=n.管理員,控制器
convenient=adj.便利的,方便的
conversation=n.會話,交談
cooker=n.炊具,蒸(煮)機,(非生吃的)為烹食所種水果
copy=n.副本,拷貝,摹仿,一冊;v.複印,複製,拷貝,抄襲
corner=n.角落,(街道)拐角處,(遙遠的)地區,偏僻處;vt.迫至一隅,壟斷,使陷入絕境;vi.相交成角,囤積(in)
costly=adj.昂貴的,貴重的
cotton=n.棉花,棉線
cough=n.咳嗽;v.咳嗽
countryside=n.鄉下地方,鄉下居民
county=n.縣,郡
couple=n.(一)對,(一)雙,夫婦;vt.連合,連接,結合;vi.結合,結婚
courage=n.勇氣,精神
court=n.法院,庭院,朝廷,宮庭,球場;vt.向…獻慇懃,追求,設法獲得(他人的支持等),博得(喝彩);vi.求愛
cousin=n.堂兄弟姊妹,表兄弟姊妹
crab=n.螃蟹,類似螃蟹的動物,脾氣乖戾的人,吹毛求疵;vi.捕蟹,偏航,發牢騷;vt.使偏航,發脾氣,破壞
crane=n.起重機
crayon=n.有色粉筆,蠟筆,粉筆畫
crazy=adj.瘋狂的,狂熱的,(指建築等)不安全的
cream=n.乳酪,奶油,(護膚)面霜
create=vt.創造,創作,引起,造成
crime=n.犯罪,犯罪行為,罪行,罪惡
crisis=n.疾病的轉折點(或轉好或惡化),決定性時刻,危機,危險期,歷史上的緊要關頭,危象,轉換期
crop=n.農作物,產量,平頭,短髮;vt.收割,修剪,種植;vi.收穫
cross=n.十字,交叉,十字架,十字形物;adj.交叉的,相反的,乖戾的;v.使交叉,橫過,勾劃,錯過,反對,雜交
crow=n.烏鴉,似烏鴉的鳥,撬棍;vi.啼叫,報曉,(嬰孩)格格地笑
crowd=n.人群,群眾,一堆(東西),一夥;v.群集,擁擠,擠滿
cruel=adj.殘酷的,悲慘的,使痛苦的
culture=n.文化,文明
cure=v.治癒,治療;n.治癒,痊癒
curious=adj.好奇的,求知的,古怪的,愛挑剔的
curtain=n.窗帘,門帘;v.裝上門帘
custom=n.習慣,風俗,<動詞單用>海關,(封建制度下)定期服勞役,繳納租稅,自定義;v.定制,承接定做活的
customer=n.消費者
daily=adj.每日的,日常的;adv.每日,日常地,天天;n.日報,<美口>朝來夜去的女佣
damage=n.損害,傷害;v.招致損害;n.(用複數)賠償金
dangerous=adj.危險的
data=n.datum的複數,資料,數據
dawn=n.黎明,拂曉,破曉;vi.破曉,開始現生,變得(為人所)明白;v.破曉
deaf=adj.聾的
debate=v.爭論,辯論;n.爭論,辯論
debt=n.債務,罪過
decision=n.決定,決心,決議,結果,果斷,堅定
decorate=v.裝飾,為…做室內裝修
degree=n.度數,度,程度,(罪行的)輕重,學位,地位,身份,次數
delay=v.耽擱,延遲,延期,遲滯;n.耽擱,延遲,遲滯
delicious=adj.美味的
deliver=vt.遞送,陳述,釋放,發表(一篇演說等),交付,引渡,瞄準,給予(打擊)
dentist=n.牙科醫生
deny=v.否認,拒絕
department=n.部,局,處,科,部門,系,學部
depend=vi.依靠,依賴
depth=n.深,深度,深奧,深刻
describe=vt.描寫,記述,形容,形容;v.描述
desert=n.沙漠,應得的賞罰,功過;adj.沙漠的,不毛的,荒涼的;vt.放棄,遺棄,逃跑;vi.逃掉,逃亡,開小差
design=n.設計,圖案,花樣,企圖,圖謀,(小說等的)構思,綱要;v.設計,計劃,謀劃,構思
desire=vt.想望,期望,希望,請求(官方丈禮);n.願望,心願,要求;v.要求
dessert=n.餐後甜點
detect=vt.察覺,發覺,偵查,探測;v.發現
develop=vt.發展,發達,發揚,進步,逐步展開(情節,音樂主題,方程式等)洗印;vi.發展,生長,發育,逐步顯示出來
development=n.發展
dew=n.露,露水般的東西,清新
dial=n.刻度盤,鐘面,轉盤,(自動電話)撥號盤;v.撥
diamond=n.鑽石,菱形
diary=n.日記
dictionary=n.字典,詞典
difference=n.差異,差別,分歧,爭論,差額,差分;adj.微分的,差動的
difficulty=n.困難,難點
dinosaur=n.恐龍
direction=n.方向,指導,趨勢,(常用複數)指示,用法,說明(書),收件人地址
director=n.主任,主管,導演,(機關)首長,(團體)理事,(公司)董事,指揮儀,控制器
disagree=vi.不一致,不適宜
disagreement=n.意見不同,不調和,爭執,不和,爭論
disappear=vi.消失,不見
discuss=vt.討論,論述
discussion=n.討論
dishonest=adj.不誠實的
display=vt.陳列,展覽,顯示;n.陳列,展覽,顯示；顯示,顯示器
distance=n.距離,遠離,一長段時間,遠方,遠景,遙遠,(時間的)間隔,(時日的)經過
distant=adj.遠的,關係遠的(親戚),疏遠的,間隔的,冷漠的
divide=v.分,劃分,分開,隔開
division=n.分開,分割,區分,除法,公司,(軍事)師,分配,分界線
dizzy=adj.(指人)暈眩的,昏亂的,(指地點,情況)使人暈眩的
dolphin=n.海豚
donkey=n.驢子,笨蛋,頑固者,(=donkey engine)輕便發動機,(=donkey pump)輔助泵
dot=n.點,圓點,園點;vt.在…上打點
double=n.兩倍,雙精度型;adj.兩倍的,雙重的;vt.使加倍;vi.加倍,快步走,加倍努力
doubt=n.懷疑,疑惑,疑問;v.懷疑,不信,拿不准,<古>恐怕
doughnut=n.油炸圈餅;n.圓環圖
downtown=adv.在市區,往市區;adj.市區的
drag=v.拖,拖曳,緩慢而費力地行動;n.拖拉
dragon=n.龍,兇暴的人,嚴厲而有警覺性的女人
dragonfly=n.蜻蜓
drama=n.(在舞台上演的)戲劇,戲劇藝術
drape=n.窗帘
drawer=n.抽屜,畫家,製圖員,(用複數)襯褲﹑內褲
drawing=n.圖畫,製圖,素描術
dress=n.女服,童裝,服裝,衣服;v.(給…)穿衣
drop=v.滴下,落下,(使聲音等)變弱,(使價格等)下降,使跌倒,使結束;n.落下,下降,滴,滴劑,點滴,微量
drug=n.藥,麻藥,麻醉藥,滯銷貨;vi.<俗> 吸毒;vt.使服毒品,毒化
drugstore=n.<美> 藥房,雜貨店
drum=n.鼓,鼓聲,鼓形圓桶,鼓膜,鼓室;vi.擊鼓,作鼓聲;vt.打鼓奏
dryer=n.乾衣機,乾燥劑
dull=adj.感覺或理解遲鈍的,無趣的,獃滯的,陰暗的;vt.使遲鈍,使陰暗,緩和;vi.變遲鈍,減少
dumb=adj.啞的,無說話能力的,不說話的,無聲音的
dumpling=n.麵團布丁,糰子
duty=n.義務,責任,職責,職務,稅
earn=vt.賺,掙得,獲得;v.賺得,獲得
earthquake=n.地震,在震蕩,在變動
eastern=adj.東方的,東部的
education=n.教育,訓導,訓練,培養,教育學
effect=n.結果,效果,作用,影響,(在視聽方面給人流下的)印象;vt.招致,實現,達到(目的等)
effective=adj.有效的,被實施的,給人深刻印象,有生力量
effort=n.努力,成就
elder=n.年長者,老人,父輩;adj.年長的,資格老的
elect=vt.選舉,推選;v.選擇,作出選擇,選舉,選舉,選舉
element=n.要素,元素,成份,元件,自然環境
elevator=n.電梯,昇降機,昇降舵
emotion=n.情緒,情感,感情
encourage=vt.鼓勵,慫恿;v.鼓勵,鼓勵
encouragement=n.鼓勵,獎勵
ending=n.結尾,結局
enemy=n.敵人,仇敵,敵軍,大敵;adj.敵人的,敵方的
energy=n.精力,精神,活力,能量
enjoy=vt.享受…的樂趣,欣賞,喜愛;v.滿意
enjoyment=n.享樂,快樂,享受樂事
entire=adj.全部的,完整的,整個
entrance=n.入口,門口,進入
envelope=n.信封,封套,封袋,包層,包跡,包膜
environment=n.環境,外界
eraser=n.擦除器,尤指墨水消除劑,橡皮
error=n.錯誤,過失,誤差
especially=adv.特別,尤其
essay=vt.企圖,嘗試;n.企圖,散文,小品文,隨筆,短文,評論
event=n.事件,事變,結果,活動,精力,競賽
exact=adj.精確的,準確的,原樣的,精密的,嚴格;vt.強求,急需,要求
excellent=adj.卓越的,極好的
excite=vt.刺激,使興奮,使激動;vi.<口>興奮,激動
excitement=n.刺激,興奮,激動,搔動
excuse=vt.原諒,申辯,做為…的托辭,為…免去;n.饒恕,致歉,理由,口實,借口,清借條,免去
exercise=n.練習,習題,訓練,鍛煉,演習;v.訓練,鍛煉;vt.行使,使擔擾
exist=vi.存在,生存,生活,繼續存在
expect=vt.期待,預期,盼望,指望,<口>(料)想,認為
expensive=adj.花費的,昂貴的
experience=n.vt.經驗,體驗,經歷,閱歷
expert=n.專家,行家,(特等)射手;adj.老練的,內行的,專門的;vt.在…中當行家,當專家
explain=v.解釋,說明
express=adj.急速的,特殊的,明確的;n.快車,快遞,專使;vt.表達,表示;adv.乘快車,以快遞方式
extra=adj.額外的,不包括在價目內的,特大的;adv.特別地,非常,另外;n.額外的人(或物),(報紙)號外,上等產品
eyebrow=n.眉毛
fail=vi.失敗,不及格,忘記;vt.使失望,捨棄,辜負,不及格;n.不及格,不及格者
failure=n.失敗,失敗者,缺乏,失靈,故障,破產,疏忽,<美>不及格
fair=adj.美麗的,女性的,(膚色)白皙的;adv.公平地,公正地,直接地;n.美好的事物,美人,展覽會;vi.轉晴
famous=adj.著名的,出名的,<口>極好的,令人滿意的
fault=n.過錯,缺點,故障,毛病;vt.挑剔;vi.弄錯
favor=n.好感,寵愛,關切,歡心,好意,喜愛;vt.支持,贊成,照顧,促成,象,喜歡,證實,賜予
favorite=n.特別喜歡的人(或物),喜歡的事物,親信,心腹,幸運兒;adj.喜愛的,寵愛的,中意的
fearful=adj.可怕的,嚇人的,恐怕的,嚴重的
fee=n.費(會費﹑學費等),酬金
fellow=n.人,傢伙,夥伴,學會特別會員,朋友,同事;adj.同伴的,同事的,同道的
female=n.女性,女人,雌獸;adj.女性的,女子的,婦女的,雌的,柔弱的,(聲,色)柔和的
fence=n.柵欄,圍牆,劍術;vt.用籬笆圍住,練習劍術,防護;vi.擊劍,圍以柵欄,跳過柵欄,搪塞
festival=n.節日,喜慶日,音樂節,戲劇節,喜慶,歡宴,歡樂;adj.節日的,快樂的
fever=n.發燒,發熱,熱病,狂熱,高度興奮;v.(使)發燒,(使)患熱病,(使)狂熱
field=n.原野,曠野,領域;vt.把(穀物等)暴晒于場上,使上場;vi.擔任場外隊員;adj.田間的,野生的；掃描場
fighter=n.斗士,戰士,鬥爭者,奮鬥者,好戰者
figure=n.外形,輪廓,體形,圖形,畫像;vt.描繪,塑造,表示,象征,演算;vi.出現,考慮,出名,扮演角色
film=n.薄膜,膜層,膠卷,影片,薄霧,輕煙;vt.在…上覆以薄膜,拍成電影;vi.生薄膜,變成朦朧,拍電影
fireman=n.救火隊員,消防隊員
firewoman=女消隊防員
firm=n.公司,(合伙)商號;adj.結實的,堅硬的;vt.使牢固,使堅定;vi.變穩固,變堅實;adv.穩固地,堅定地
fisherman=n.漁民,漁夫
fit=n.突然發作,適合,痙攣,一陣;adj.合適的,恰當的,健康的,;vt.適合,安裝,使合身;vi.適合,符合
fix=vt.使固定,裝置,修理,準備,安裝,凝視,整理;vi.固定,注視,決定,選定,確定;n.困境,方位,賄賂
flag=n.旗,標記;v.標記
flash=Macromedia 公司開發的動畫編輯工具;n.閃光,閃現;vi.閃光,閃現;vt.使閃光,反射;adj.閃光的,火速的
flashlight=n.手電筒,閃光燈
flat=adj.平坦的,扁平的,單調的;adv.平直地,仰臥地,恰恰;n.平面,平地,一層;v.(使)變平,(使)降半音
flight=n.飛行,逃走,飛躍,飛機的航程,班機,追逐,樓梯的一段;vi.成群飛行,遷徙;vt.射擊(飛禽),使驚飛
flood=n.洪水,水災,(因雨)漲潮,水;vt.淹沒,使氾濫,注滿,充滿;vi.被水淹,溢出,涌進,噴出,涌出
flour=n.麵粉
flow=n.流程,流動,(河水)氾濫,洋溢;vi.流動,涌流,川流不息,飄揚;vt.溢過,淹沒
flu=n.流感
flute=n.長笛,笛狀物,凹槽
focus=n.(興趣活動等的)中心,焦點,焦距,病灶;vi.聚焦,注視;vt.使集中在焦點上,定焦點,調焦,集中
foggy=adj.霧深的,模糊的,朦朧的,(玻璃窗等)不明淨的
following=n.下列各項,部下,黨羽;adj.下列的,其次的;介.在…之後
fool=n.愚人,白痴,莽漢,受騙者,奶油拌水果;vt.愚弄,欺騙,浪費;vi.幹傻事,開玩笑,游蕩;adj.傻的
foolish=adj.愚蠢的,傻的,笨的,鹵莽的,可愛的
football=n.足球,橄欖球
foreigner=n.外國人,外地人
forgive=vt.原諒,饒恕,寬免(某人)之債務
form=n.形狀,形態,外形,表格,形式;v.形成,構成,排列,(使)組成
formal=adj.外形的,正式的,合禮儀的,形式的,整齊勻稱的;n.正式的社交活動
former=adj.從前的,以前的;n.形成者,創造者,模型,樣板
forward=adj.早的,迅速的,前進的;vt.轉寄,促進,運送;adv.向前地,向將來;n.(足球等)前鋒
forwards=adv.(=forward)向前方,繼續向前
fox=n.狐狸,狐皮,狡猾的人;vi.奸狡地行動,變酸;vt.使變酸,使生黃斑
frank=adj.坦白的,率直的,老實的;vt.免費郵寄;n.免費郵寄特權
freedom=n.自由,自主,直率,特權
freezer=n.制冰淇淋者,冷藏工人
fridge=n.電冰箱
friendly=adj.友好的,友誼的
fright=n.驚駭,吃驚
frighten=vt.使驚嚇;vi.驚恐
function=n.官能,功能,作用,職責,典禮,儀式,函數;vi.(器官等)活動,運行,行使職責
further=adj.更遠的,更多的,深一層的;vt.促進,增進,助長;adv.更進一步地,更遠地,此外
future=n.未來,將來,前途,遠景;adj.未來的,將來的
gain=n.財物的增加,財富的獲取,利潤,腰槽,收穫;vt.得到,增進,賺到,開腰槽于;vi.獲利,增加
garage=n.汽車間,修車廠,車庫;v.放入車庫
garbage=n.垃圾,廢物
gardener=n.園丁
gate=n.大門
gather=n.集合,聚集;vi.集合,聚集,漸增,蹙眉,化膿;vt.使聚集,蒐集,積聚,推斷
general=n.普通,將軍,概要;adj.一般的,普通的,綜合的,概括的,全面的,大體的 ;n.常規
generous=adj.慷慨的,大方的,有雅量的
gentle=adj.溫和的,文雅的
gentleman=n.閣下,先生,有身份的人,紳士,男廁所,男盥洗室
geography=n.地理學,地理
giant=n.巨人,大力士,巨大的動物或植物,偉人,天才;adj.龐大的,巨大的
giraffe=n.長頸鹿,鹿豹座
glove=n.手套;vt.戴手套
glue=n.膠,膠水;vt.膠合,粘貼,粘合
goal=n.目的,目標,守門員,球門,(球賽等的)得分
goat=n.山羊,<俚>色鬼,<美俚>替罪羊
golden=adj.金色的,金黃色的,貴重的,極好的,黃金的
golf=n.高爾夫球;vi.打高爾夫球
govern=v.統治,支配,管理
government=n.政府,<英>內閣,政治,政體
grade=n.等級,級別;vt.評分,評級;v.分等級
grape=n.葡萄,葡萄樹
grassy=adj.綠色的,象草的
greedy=adj.貪吃的,貪婪的,渴望的
greet=vt.問候,向…致意,獲悉(消息),映入眼帘
growth=n.生長,種植,栽培,發育,等比級數
guard=n.守衛,警戒,護衛隊,防護裝置;vt.保衛,看守,當心;vi.防止,警惕,警衛
guava=n.番石榴
guitar=n.吉他,六弦琴;vi.彈吉他
guy=n.傢伙,人
habit=n.習慣,習性
hall=n.會堂,禮堂,大廳,走廊,門廳
hamburger=n.<美> 碎牛肉,牛肉餅,漢堡包
hammer=n.鐵錘,槌,錘子;v.錘擊,錘打
handkerchief=n.手帕
handle=n.柄,把手,把柄,口實,手感;vt.觸摸,運用,買賣,處理,操作;vi.搬運,易于操縱;n.句柄
handsome=adj.英俊的,大方的,慷慨的,美觀的,堂皇的
hang=n.懸掛的方式,（動作的）暫停,中止;vt.懸掛,附著,裝飾,絞死;vi.懸著,垂下,被絞死,懸而不決
hanger=n.絞刑執行者,衣架
hardly=adv.剛剛,幾乎不,僅,嚴厲的,艱辛的
hateful=adj.可恨的,討厭的,可惡的
healthy=adj.健康的,健壯的,有益于健康的
heater=n.加熱器,發熱器
height=n.高度,海拔,高地(常用複數),頂點
helpful=adj.有幫助的,有用的,有益的
hen=n.母雞,雌鳥
hero=n.英雄,男主角,男主人公
heroine=n.女英雄,女主人公
hide=n.獸皮,皮革;v.剝…的皮,痛打,隱藏,掩藏,隱瞞,掩飾
highway=n.公路,大路
hip=n.臀,薔薇果,憂鬱;adj.熟悉內情的;vt.使憂鬱,給（屋頂）造屋脊;感.喝彩聲
hippo=n.河馬
hippopotamus=n.河馬
hire=n.租金,工錢,租用,僱用;vt.僱請,出租;vi.受僱
hobby=n.業余愛好
holder=n.持有者,佔有者,(臺﹑架等)支持物,固定器
homesick=adj.思家的,思鄉病的
honest=adj.誠實的,正直的
honey=n.(蜂)蜜,蜂蜜
hop=v.單腳跳,(鳥,蛙等)跳躍;n.蛇麻草
hospital=n.醫院
host=n.主人,旅館招待 許多;vt.當主人招待；主機
hostess=n.女主人,女房東,女老闆,女服務員,舞女
hotel=n.旅館,客棧,<俚>監獄
however=adv.無論如何,可是,仍然,究竟;連.不管用何種方法,然而,可是
hum=v.嗡嗡叫,哼;n.嗡嗡聲,吵雜聲
humble=adj.卑下的,微賤的,謙遜的,粗陋的;vt.使…卑下,挫,貶抑
humid=adj.充滿潮濕的,濕潤的,多濕氣的
humor=n.幽默,心情,詼諧;vt.迎合,牽就,順應
hunger=n.飢餓,慾望,渴望;v.飢餓
hunt=v.打獵,獵取,搜索,搜尋,獵獲;n.打獵,獵取,搜索,搜尋,狩獵
hunter=n.獵人
hurry=v.(使)趕緊,(使)匆忙,加速;n.匆忙,倉促
icebox=n.冷藏庫,冰箱
ignore=vt.不理睬,忽視,(因證據不足而)駁回訴訟
ill=adj.有病的,壞的,惡意的,生病
imagine=vt.想象,設想
importance=n.重要(性),重大,價值,傲慢
improve=v.改善,改進
improvement=n.改進,進步
include=vt.包括,包含
income=n.收入,收益,進款,所得
increase=n.增加,增大,增長;vt.增加,加大;vi.增加,繁殖
independence=n.獨立,自主
independent=n.中立派,無黨派者;adj.獨立自主的,不受約束的
indicate=vt.指出,顯示,象征,預示,需要,簡要地說明
industry=n.工業,產業,行業,勤奮
influence=n.影響,感化,勢力,有影響的人(或事),(電磁)感應;vt.影響,改變
ink=n.墨水
insect=n.昆蟲,卑鄙的人;adj..蟲的,蟲子一樣的,對付蟲子的
insist=v.堅持,強調
instance=n.實例,建議,要求,情況,場合;vt.舉…為例,獲得例證
instant=adj.立即的,直接的,緊迫的,刻不容緩的,(食品)速溶的,方便的,即時的
instrument=n.工具,手段,器械,器具,手段
international=adj.國際的,世界的;n.國際性組織,國際比賽
interview=vt.接見,會見;n.接見,會見
introduce=vt.介紹,傳入,引進,提出
invent=vt.發明,創造;v.發明
invitation=n.邀請,招待
invite=vt.邀請,引起;n.邀請
island=n.島,島嶼,島狀物(孤立狀態的物),安全島;vt.使成島狀,孤立
item=n.(可分類或列舉的)項目,條款,(消息﹑情報等的)一則,一條
jacket=n.短上衣,夾克,(鍋爐﹑水管等的)套,書籍的封面套紙,護封,馬鈴薯皮;vt.給…穿夾克,給…裝護套
jam=n.果醬,擁擠,堵塞,困境;vt.擠進,使塞滿,混雜,壓碎,使堵塞;vi.堵塞,軋住,擁擠
jazz=n.(20世紀產生于美國的一種舞曲性音樂)爵士樂,喧鬧;adj.爵士樂的,喧吵的;vi.奏爵士樂;vt.奏爵士樂
jeans=n.斜紋布褲,牛仔褲
jeep=n.吉普車
jog=n.輕推,輕撞,漫步;v.輕推,(使)蹣跚行進,(使)慢跑
joint=n.接縫,接合處,接合點,關節;adj.共同的,聯合的,連接的;vt.連接,接合,使有接頭;vi.貼合,生節
judge=n.法官,審判員,裁判員,鑒賞家,鑒定人;vt.審理,鑒定,判斷,判決,斷定;vi.下判斷,作評價
juicy=adj.多汁的,潮濕的,有趣的,報酬多的
ketchup=n.調味蕃茄醬
kindergarten=n.幼兒園;adj.幼兒園的,初級的,啟蒙階段的
kingdom=n.王國,天國,上帝的統治,領域
knock=v.敲,敲打,敲擊,(使)碰撞;n.敲,擊,敲打
knowledge=n.知識,學問,認識,知道,<古>學科
koala=n.樹袋熊(澳洲產,樹棲無尾動物)
ladybird=n.瓢蟲
ladybug=n.瓢蟲
lane=n.（鄉間）小路,巷,里弄,狹窄的通道,航線
language=n.語言,語言文學,術語,語言表達能力,(運用語言的)方式﹑能力﹑風格,（機器）代碼
lantern=n.燈籠,提燈,幻燈,信號,天窗
lap=n.(坐時的)大腿前部,膝蓋,舔聲,(水)濺潑聲;vi.重疊,圍住,輕拍,舔;vt.包圍,抱…在膝上,使重疊
latest=adj.最近的
lawyer=n.律師
leadership=n.領導能力,領導階層
legal=adj.法律的,法定的,合法
lemon=n.檸檬;adj.檸檬色的
lemonade=n.檸檬水
lend=v.借給,貸(款)
length=n.長度,長,時間的長短,音長
leopard=n.豹,美洲豹.美洲虎
lettuce=n.萵苣,生菜,苦菜類,<俚>紙幣
library=n.圖書館,藏書室,庫
lick=n.舔,少許,打;vt.舔,卷過,鞭打,克服,征服;vi.輕輕拍打
lid=n.蓋子,<美口>限制,眼瞼;vt.給…蓋蓋子
lightning=n.閃電；(“閃電”) 英國第一種超音速噴氣式戰鬥機﹐英60年代的主力機種。
limit=n.界限,限度,限制;vt.限制,限定
link=n.鏈環,連結物,火把,鏈接;vt.連結,聯合,挽;vi.連接起來
liquid=n.液體,流體,流音;adj.液體的,清澈的,透明的,明亮的,流動的,易變的,(財務)易變賣的
listener=n.收聽者,聽眾
loaf=n.一條麵包,塊,游蕩;v.游蕩,虛度光陰
local=adj.地方的,當地的,局部的,鄉土的;n.當地居民,本地新聞,慢車,局部
locate=vt.查找…的地點,使…坐落于,位於;v.定位,位於
lock=n.鎖;v.鎖,鎖上,鎖住
log=n.航行日誌,原木,園形木材,園木;v.把…記入航行日誌,伐木,把…鋸成段
lone=adj.孤獨的,獨立的
lonely=adj.孤獨的,寂寞的,偏僻的,人跡罕至的
lose=vt.遺失,浪費,錯過,輸去,使失去,使迷路,使沉溺于;vi.受損失,失敗
loser=n.失主,失敗者,輸者
loss=n.損失,遺失,失敗,輸,浪費,錯過,傷亡,降低
lovely=adj.可愛的,有趣的
lover=n.愛人,愛好者,情人
lower=adj.較低的,下級的,下等的,下游的;vi.降低,跌落,減弱;vt.放下,降下,減弱,貶低
luck=n.運氣,好運,幸運
magazine=n.雜誌,期刊,軍火庫,彈藥庫,(槍﹑炮的)彈倉,膠卷盒
magic=n.魔法,巫術,戲法;adj.魔術的,有魔力的,不可思議的
magician=n.善於變戲法的人,魔術師,術士
main=n.主要部份,體力,力量,大陸,要點,幹線;adj.主要的,重要的,全力的;n.主群組
maintain=vt.維持,維修,繼續,供養,主張
male=adj.男的,雄的,男性
mango=n.芒果
manner=n.禮貌,風格,方式,樣式,習慣
mark=n.標誌,分數,痕跡,記號;vt.做標記于,打分數,標誌;vi.作記號
marriage=n.結婚,婚姻,婚姻生活,密切結合,合併
mask=n.面具,掩飾,石膏面像;vt.戴面具,掩飾,使模糊;vi.化裝,戴面具,掩飾,參加化裝舞會
mass=n.塊,大多數,質量,群眾,大量;adj.群眾的,大規模的,集中的;vt.使集合;vi.聚集
mat=n.蓆子,墊子;v.鋪蓆子
match=n.火柴,比賽,競賽,匹配,(足球,捧球,藍球)比賽;v.相配,相稱,比賽,相比,匹配
mate=n.配偶,對手,助手;vt.使配對,使一致,結伴;vi.成配偶,緊密配合
material=n.材料,原料,物資,素材,布料;adj.物質的,肉體的,具體的,重要的,實質性的
meal=n.一餐,一頓飯,膳食,(穀類的)粗粉;vi.進餐
meaning=n.意義,含意,意圖,內涵;adj.意味深長的
means=n.手段,方法;v.意味,想要
measurable=adj.可測量的
measure=n.尺寸,量度器,量度標準,方法,測量,措施;vt.測量,測度,估量,分派,權衡,調節;vi.量
measurement=n.測量法,度量,(量得的)尺寸,度量單位制
medicine=n.藥,醫學,內科學,內服藥;vt.給…用藥
meeting=n.會議,集會,會見,會戰,匯合點
melody=n.悅耳的音調
melon=n.(各種的)瓜
member=n.成員,會員,議員,(人或動,植物的)一部份,子句,成份,推論的命題
memory=n.記憶,記憶力,回憶,存儲(器),存儲器；存儲器,內存
menu=n.菜單
message=n.消息,通訊,訊息,音訊,差使,廣告詞,預言,教訓;vt.通知;vi.帶信息
metal=n.金屬
meter=n.米,公尺,計,表,儀俵
method=n.方法
military=adj.軍事的,軍用的
million=數.百萬,百萬個;n.無數
mine=n.礦,礦山,礦井,源泉,寶庫,地雷;vt.挖掘,開採,在…布雷,破壞;vi.開礦,埋設地雷;代.我的
minus=adj.負的,減的;介.減去;n.負數
mirror=n.鏡子,真實反映情況的東西,典範;vt.反映,映出;n.DOS命令﹕在磁盤安全區域存貯根目錄和文件分配表
mix=v.使混和,混淆,混合;n.混合
model=n.樣式,型,模範,典型,模型,原型,模特兒;vt.模仿;v.模擬
modern=n.現代人,有思想的人;adj.近代的,現代的,現代化的,時髦的
monster=n.怪物,妖怪
mosquito=n.蚊子
moth=n.蛾,蛀蟲
motion=n.運動,動作;v.運動
motorcycle=n.摩托車,機車
movable=adj.活動的,變動的
MRT=Mass Rapid Transit 大規模快運系統
mule=n.騾,倔強之人,頑固的人,雜交種動物
multiply=v.繁殖,乘,增加
museum=n.博物館
musician=n.音樂家
nail=n.指甲,釘,釘子;vt.釘,將…釘牢
naked=adj.裸體的,無遮蓋的,無裝飾的,無保護的,無證據的,未證實的
napkin=n.餐巾,餐巾紙,<英>尿布,<美>月經帶
narrow=n.狹窄部份,海峽,隘路;adj.狹窄的,精密的,嚴密的,有限的,氣量小的;vi.變窄;vt.使變狹窄,使縮小
national=adj.國家的,國立的,民族的
natural=adj.自然的,自然界的,關於自然界的,天生的,天賦的,普通的,正常的,簡單自然的；本位號
naughty=adj.頑皮的,淘氣的,不聽話的,沒規矩的,不適當的,下流的
nearby=adj.附近的,鄰近的;adv.在附近
nearly=adv.幾乎,密切地
neat=adj.整潔的,靈巧的,優雅的,(酒)純的,未攙水的
necessary=n.必需品;adj.必要的,必需的,必然的
necklace=n.項鏈
needle=n.針
negative=n.否定,負數,底片;adj.否定的,消極的,負的,陰性的;vt.否定,拒絕(接受)
neighbor=n.<美> 鄰居,鄰國
neither=adj.pron.兩者都不;連.既不…又不,也不
nephew=n.侄子,外甥
nest=n.巢,窩,休息所,隱匿處,舒適的地方,(可以一個套一個的)一套器具;vi.筑巢,找鳥巢;vt.造巢,使套入
net=n.網,網絡;adj.淨余的,純粹的;vt.用網捕,淨賺;vi.編網； Nerwork operations and service centers
niece=n.姪女,甥女
nobody=代.誰也不,無人,任何人,沒有任何人
nod=v.點頭,點…；n.點頭
none=adv.決不,毫不;代.一個也沒有,毫無
noodle=n.麵條(常用複數),笨蛋,傻瓜
northern=adj.北方的,北部的
notebook=n.筆記簿,筆記本
novel=n.小說,長篇故事;adj.新奇的,新穎的,異常的
nut=n.堅果,螺母,螺帽,難解的問題
obey=v.服從,順從
object=n.物體,目標,賓語,對象;vi.反對,拒絕,抗議;vt.提出…來反對
occur=vi.發生,出現
offer=n.出價,提議,意圖;vt.提供,出價,貢獻,使出現,企圖,演出;vi.(機會﹑時機等)出現,獻祭,提議
official=n.官員,公務員;adj.職務上的,公務的,官方的,正式的
omit=vt.省略,疏忽,遺漏
onion=n.洋蔥;vt.加洋蔥于,因洋蔥掉淚
operate=v.操作,運轉,開動,起作用,動手術,開刀;n.作軍事行動
opinion=n.意見,看法,主張,判斷,評價
ordinary=adj.平常的,普通的,平凡的;n.推事,<英>罪犯的懺悔牧師
organ=n.元件,機構,機關,機關報；風琴,管風琴,嗓音；器官
organization=n.組織,機構,團體
organize=vt.組織,使有機化,給予生機;vi.組織起來
oven=n.烤箱,烤爐,灶
overpass=n.<美>天橋,陸橋;vt.勝過,通過,忽視
overseas=adv.海外;adj.外國的,海外的
owl=n.貓頭鷹,梟,慣于晚上活動的人；Object Window Library,Borland C++ 的類庫
owner=n.所有者,業主
ox=n.牛,公牛
pack=n.包裹,<貶>一群,一副,背包,包裝;vt.包裝,捆扎,塞滿,壓緊;vi.包裝貨物,擠,群集,被包裝；背包
package=n.包裹,包
pain=n.痛苦,疼,痛,勞苦,努力;vt.使痛苦
painful=adj.疼痛的,使痛苦的
painter=n.畫家,油漆匠
painting=n.上油漆,著色,繪畫,油畫;v.描繪
pajamas=n.睡衣,寬長褲
palm=n.手掌,棕櫚,(象征勝利的)棕櫚葉;vt.與…握手,藏…于掌中,蒙混
pan=n.平底鍋,盤子,面板
panda=n.熊貓,黑白相間的熊類
papaya=n.番木瓜樹,番木瓜果
pardon=vt.原諒,寬恕;n.原諒,寬恕
parrot=n.鸚鵡,學舌者,機械模仿別人的人;vt.學舌
particular=n.細節,詳細;adj.特殊的,特別的,獨特的,詳細的,精確的,挑剔
partner=n.合伙人,股東,舞伴,伴侶;vt.與…合伙,組成一對;vi.做夥伴,當助手
passenger=n.乘客,旅客
paste=n.糊,麵團,黏土團;vt.用漿糊粘,張貼;n.粘貼
pat=n.輕拍,(黃油)小塊;v.輕拍;adv.適時,正好,恰好;adj.恰好的,合適的,人為的
path=n.小路,小徑,路線,軌道,通道
patient=n.病人,患者;adj.忍耐的,耐心的
pattern=n.模範,式樣,模式,樣品,格調,圖案;vt.模仿,仿造,以圖案裝飾;vi.形成圖案
peace=n.和平,和睦,安寧,靜寂;vi.安靜下來
peaceful=adj.和平的,平靜的,安寧的,愛好和平的
peach=n.桃子,桃樹,桃色,<美俚>受人喜歡的人(或物);vt.告發;vi.告密
peanut=n.花生
pear=n.梨子,梨樹
penguin=n.企鵝
pepper=n.胡椒粉
per=介.每,每一,由,經
perfect=n.完成式;adj.完美的,全然的,理想的,正確的,熟練的,精通的完成式的;vt.使完美,修改,使熟練
period=n.時期,學時,節,句點,週期,（婦女的）經期;adj.過去某段時期的;感.沒有了
personal=adj.私人的,個人的,親自的,容貌的,身體的,人身的,針對個人的;adj.人稱的
phone=n.電話,電話機;v.(給…)打電話
photo=n.照片
photograph=n.照片
photographer=攝影師;n.攝影師
phrase=n.短語,習語,慣用語,成語,措詞;vt.用短語表達
pick=n.精選,掘,鶴嘴鋤;vt.摘,掘,鑿,挑選,挖,挑剔;vi.摘,掘,鑿,挖,挑選;v.拾取
picnic=n.野餐;vi.(去)野餐
pigeon=n.鴿子
pile=n.堆,大堆,高大建築,<美口>大量錢財;vi.堆起,堆積,積累,擠;vt.堆于,累積,堆疊,打樁于
pillow=n.枕頭,枕墊
pin=n.釘,銷,栓,大頭針,別針,腿;vt.釘住,別住,阻止,扣牢,止住,牽制
pineapple=n.鳳梨,菠蘿
ping-pong=n.乒乓,桌球
pink=n.粉紅色,石竹花,化身,極致,精華;adj.粉紅的;vt.刺,扎,刺痛,使變粉紅色;vi.變粉紅色
pipe=n.管,導管,煙斗,管樂器,笛聲;vt.以管輸送,吹哨子;vi.吹笛,尖叫
pitch=n.程度,斜度,樹脂,投擲,定調;vt.投,擲,向前傾跌,定位於,用瀝青涂;vi.搭帳篷,投擲,墜落,傾斜
pizza=n.比薩餅（一種涂有乳酪核番茄醬的意大利式有餡烘餅）
plain=n.平原,草原;adj.簡單的,明白的,平常的,清晰的,普通的,樸素的;adv.清楚地;n.無格式
planet=n.行星
plate=n.盤子,金屬板,圖版,金銀餐具;vt.鍍（金,銀等）,電鍍,給…裝鋼板
platform=n.(車站)月臺,講臺,講壇；平臺
playful=adj.好玩的,嬉戲的,十分有趣的,頑皮的
pleasant=adj.令人愉快的,舒適的
pleasure=n.愉快,快樂,樂事,樂趣,意志,願望
plus=介.加上;adj.正的,加的
poem=n.詩,象詩一樣,美麗的東西
poet=n.詩人
poison=n.毒藥,敗壞道德之事,毒害;vt.毒害,敗壞,使中毒;vi.放毒,下毒
policy=n.政策,方針
polite=adj.有禮貌的,客氣的,有教養的,文雅的
popular=adj.通俗的,流行的,受歡迎的
population=n.人口
pork=n.豬肉,<美俚><粗>與(女子)性交
port=n.港口,艙門,左舷,避風港,槍眼;vt.左轉舵,持(槍);vi.轉舵左;n.端口
pose=n.姿勢,姿態;v.(使…)擺好姿勢,形成,引起,造成;vi.擺姿勢,佯裝,矯揉造作
positive=adj.肯定的,實際的,積極的,絕對的,確實的;adj.正的;adj.陽的;adj.原級的
possibility=n.可能性,可能發生的事物
post=n.柱,郵件;vt.張貼,揭示;vi.快速旅行;adv.加速地;縮.Passive Optical Seeker Technique
postcard=n.明信片,風景明信片
pot=n.罐,壺;v.罐裝
potato=n.馬鈴薯
pound=n.磅,英鎊,重擊,魚塘,獸欄,拘留所;vt.強烈打擊,搗爛,監禁,關入欄;vi.連續重擊,連續敲打,苦幹
powerful=adj.強大的,有力的
praise=vt.讚揚,歌頌,稱讚;n.讚揚,讚美的話,讚美,榮耀,稱讚
pray=v.祈禱,懇求,請
prefer=vt.更喜歡,寧願
presence=n.出席,到場,存在
present=n.贈品,禮物,現在,瞄準;adj.現在的,出席的,當面的;vt.介紹,引見,給,贈送,上演;vi.舉槍瞄準
president=n.總統,會長,校長,行長
press=n.壓,按,印刷,壓力,擁擠,緊握,新聞;vt.壓,壓榨,緊抱,逼迫;vi.壓,逼迫,擁擠,受壓
pride=n.自豪,自尊(心),驕傲,傲慢;vt.使自豪,使自誇
prince=n.王子
princess=n.公主
principal=n.負責人,首長,校長,主犯,本金;adj.主要的,首要的
principle=n.法則,原則,原理
printer=n.印刷工,打印機
prison=n.監獄
prisoner=adj.囚犯的;n.戰俘
private=adj.私人的,私有的,私營的,秘密的;n.士兵
prize=n.獎賞,獎金,獎品,捕獲,捕獲物,戰利品;adj.得獎的;vt.珍視,估價,捕獲,撬,撬開
produce=n.產物,農產品;vt.提出,出示,生產,製造,結(果實),引起,招致,創作
producer=n.生產者,製作者,演出人,(電影)製片人
progress=n.前進,進步,發展;vi.前進,進步,進行
project=n.計劃,方案,事業,企業,工程;v.設計,計劃,投射,放映,射出,發射(導彈等),凸出
promise=vt.允諾,答應;n.允諾,答應,許諾
pronounce=v.發音,宣告,斷言
propose=vt.計劃,建議,向…提議,求(婚);vi.打算,求婚
protect=vt.保護
proud=adj.自豪的,得意的,驕傲的,妄自尊大的
provide=v.供應,供給,準備,預防,規定
pudding=n.布丁(一種以麵粉,牛奶,雞蛋等為基料的糊壯甜食)
pump=n.泵,抽水機;vt.(用泵)抽(水),抽吸
pumpkin=n.南瓜
punish=vt.懲罰,處罰
punishment=n.懲罰,處罰,懲處
pupil=n.學生,小學生,瞳孔
puppet=n.傀儡,木偶
puppy=n.(常指未滿一歲的)小狗,小動物,自負的青年
purse=n.錢包
puzzle=n.難題,謎;v.(使)迷惑,(使)為難,迷惑不解
quality=n.質量,品質,性質
quantity=n.量,數量
quarter=n.四分之一,方向,地區,方面,季,季度,一刻鐘;數.四分之一,刻
quit=vi.離開,辭職,停止;vt.離開,放棄,解除,停止
quiz=n.測驗,提問,惡作劇;v.對…進行測驗,盤問,挖苦
rabbit=n.兔,野兔
rainy=adj.下雨的,多雨的
range=n.山脈,行列,範圍,射程;vt.排列,歸類于,使並列,放牧;vi.平行,延伸,漫游
rapid=adj.迅速的,飛快的,險峻的;n.急流,高速交通工具,高速交通網
rare=adj.稀罕的,傑出的,珍貴的,(肉類)半熟的;adv.非常
rather=adv.寧願,寧可,更正確,更合適,有點,相當
reality=n.真實,事實,本體,逼真
realize=vt.認識到,了解,實現,實行
recent=adj.新近的,近來的
record=n.履歷,檔案,訴狀,最高紀錄,報告,唱片;vt.記錄,標明,將…錄音;vi.錄音,被錄音;adj.創紀錄的
rectangle=n.長方形,矩形
refrigerator=n.電冰箱,冷藏庫
refuse=vt.拒絕,謝絕;n.廢物,垃圾
regard=n.關心,注意,尊敬,尊重,致意,問候,關係;vt.看待,當作,重視,尊敬,關係
region=n.區域,地方,(世界上某個特定的)地區,(藝術,科學等的)領域,(大氣,海水等的)層
regular=adj.規則的,有秩序的,經常的,(花)整齊的,常備軍的,等邊的;n.正規軍,正式隊員;adv.經常地;n.正常體
reject=n.被拒之人,被棄之物,不合格品,落選者,不及格者;vt.拒絕,抵制,否決,嘔出,駁回,丟棄
relation=n.關係,聯繫,敘述,故事,親戚
relationship=n.關係,關聯
repeat=n.重複,反復;vt.重做,復述,向他人轉述,複製,使再現;vi.重複,留有味道
reply=n.答復,報復,答辯;vi.答復,回擊,報復,答辯;vt.回答
reporter=n.記者,通訊員
require=vt.需要,要求,命令
requirement=n.需求,要求,必要條件,需要的東西,要求必備的條件
respect=n.尊敬,敬重,注意,考慮,尊重,關係,有關,敬意;vt.尊敬,尊重,不防礙
responsible=adj.有責任的,可靠的,可依賴的,負責的
rest room=n.（公共建築物內的）公用廁所,洗手間﹐休息室
restaurant=n.餐館,飯店
result=n.結果,成效,計算結果;vi.起因,由於,以…為結果,導致
review=vt.回顧,復習;n.回顧,復習,評論
riches=n.財富,財產
roach=n.蟑螂;vt.使成拱狀
rock=n.岩石,暗礁,石頭,搖動;vt.搖擺,使動搖;vi.搖,搖動
rocky=adj.多岩石的,堅如岩石的,堅固的,搖搖晃晃的,頭暈目眩的,困難的
role=n.角色,任務
roll=adj.滾動,滾轉,(使)搖擺,(使)搖晃,捲起,卷攏;vt.輾,軋;n.(一)卷,卷形物,搖晃,擺動,名單
royal=adj.王室的,皇家的,第一流的,高貴的
rude=adj.粗魯的,無禮的,猛烈的,殘暴的,粗魯無禮的
ruler=n.統治者,管理者,尺,直尺;n.標尺,劃線板,劃線的人
runner=n.奔跑者,信使
rush=n.匆促,沖進,急流,燈芯草;vi.沖,奔,闖,趕緊,涌現;vt.使沖,匆忙地做,突襲,飛躍;adj.急需的
safety=n.安全,保險,安全設備,保險裝置
sailor=n.海員,水手,不大會暈船的人,船員
salad=n.色拉
salty=adj.有鹽分的,咸味濃的
sample=n.標本,樣品,例子;vt.取樣,採樣,抽取…的樣品,試驗的一部份,嘗試
sandwich=n.夾心麵包,三明治;vt.夾入中間;v.做成三明治
satisfy=vt.滿足,使滿意,說服,使相信;v.滿意,確保
sauce=n.沙司,醬油,調味料;vt.調味,使增加趣味
science=n.科學,自然科學,理科
scientist=n.科學家
scissors=n.剪刀
score=n.得分,樂譜,抓痕,二十,終點線,刻痕;vt.把…記下,刻劃,劃線,獲得,評價;vi.記分,刻痕,得分
screen=n.屏,銀幕,篩子,掩蔽物,屏風;vt.掩蔽,包庇,放映,拍攝,篩;vi.拍電影
search=n.搜尋,查究;v.搜索,搜尋,探求,調查
secret=n.秘密,秘訣,奧秘;adj.秘密的,隱秘的,幽靜的﹑
secretary=n.秘書,書記,部長,大臣
section=n.部份,斷片,部件,節,項,區,地域,截面
select=vt.選擇,挑選;adj.精選的
selection=n.選擇,挑選,選集,精選品
semester=n.學期
separate=adj.分開的,分離的,個別的,單獨的;v.分開,隔離,分散,分別
serious=adj.嚴肅的,認真的,嚴重的
servant=n.僕人
settle=n.有背的長凳;vt.安放,使定居,安排,解決,決定,整理,支付;vi.安家,定居,停留,下陷,沉澱,決定
settlement=n.沉降,解決,結算,殖民,殖民地
share=n.共享,參與,一份,部份,份額,參股;vt.分享,均分,共有,分配;vi.分享； 使DOS支持文件共享和鎖定
shelf=n.架子,擱板
shell=n.貝殼,殼,外形,砲彈;vt.去殼,脫落,炮轟;vi.剝落,脫殼； 設定命令行解釋器的位置
shock=n.打擊,震動,衝突,休克;vt.使震動,使休克,使受電擊,震驚得;vi.震動,嚇人;adj.蓬亂的,濃密的
shoot=n.射擊,發射,攝影,急流;vt.射擊,投射,伸出,拍攝,用完,揮出;vi.射出,射擊,發出,發芽,射門
shorts=n.短褲
shower=n.陣雨,淋浴,(一)陣,(一)大批;vt.大量地給與
shrimp=n.小蝦;v.捕蝦
sidewalk=n.人行道
sign=n.標記,符號,記號,徵兆,跡象,征候;v.簽名(于),署名(于),簽署
silence=n.靜,寂靜,沉默,靜默;vt.使沉默,使安靜;v.壓制
silent=adj.寂靜的,沉默的,無聲的,無記載的
silk=n.絲綢
similar=adj.相似的,類似的
simply=adv.簡單地,完全,簡直,僅僅,只不過,樸素地,只是
single=adj.單一的,單身的,單純的,孤獨的,專一的,個別的;n.一個,單打,單精度型;vt.選出;vi.作一壘打
sink=vi.沉下,(使)下沉;n.水槽,水池；接收器
skilled=adj.熟練的
skillful=adj.靈巧的,熟練的,製作精巧的
skinny=adj.皮的,似皮的,膜狀的,小的
skirt=n.裙子;v.環繞
sleepy=adj.睏乏的,欲睡的
slender=adj.苗條的,微薄的,微弱的
slide=v.(使)滑動,(使)滑行;n.滑,滑動,幻燈片
slim=adj.苗條的,纖細的,不足取的,無價值的,細長的;v.變細,減肥
slip=n.滑倒,事故;vi.滑動,滑倒;vt.使滑動,滑過;adj.滑動的,活絡的;縮.Serial Line Interface Protocol
slipper=n.拖鞋,制輪器;vt.用拖鞋打(孩子等)
snack=n.小吃,快餐,一份;v.吃快餐(小吃)
snail=n.蝸牛,遲鈍的人;v.捉蝸牛,緩慢移動
snowy=adj.雪的,多雪的
soccer=n.英式足球
social=adj.社會的,愛交際的,社交的,群居的
society=n.社會,…會,…社,友伴,交際,社交界,上流社會
sock=n.短襪,鞋內襯底,輕軟鞋;vt.給…穿襪,重擊;vi.愛吃零食;adj.非常成功的;adv.正著地,不偏不倚地
soldier=n.士兵,軍人
solution=n.解答,解決辦法,溶解,溶液；解決方案
solve=vt.解決,解答
somebody=n.重要人物,有名氣的人;代.有人,某人
somewhere=adv.某處,在某處
sort=n.種類,類別;v.分類,揀選
source=n.來源,水源,消息來源,原始資料,發起者；源,源極
southern=adj.南的,南方的
soybean=n.大荳
speaker=n.說話者,演講人,演說者,揚聲器,喇叭
speed=n.迅速,速度,速率;v.加快,速飛,飛跑
spelling=n.拼法,拼寫法
spider=n.蜘蛛,設圈套者,三腳架
spinach=n.菠菜,胡說八道
spirit=n.精神,靈魂,幽靈,妖精,勇氣,火力,熱情,情緒;vt.誘拐,鼓勵,鼓舞
spot=n.班點,污點,地點,場所,現場;v.沾污,弄臟,偵察;vt.認出,發現
spread=n.伸展,展開,傳播,蔓延,酒席,讌會,桌布;v.伸展,展開,鋪,涂,敷,擺,傳播,散佈
spring=n.春天,躍起,泉,彈簧,發條,彈性,彈力,根源;v.跳,躍,躍出,使跳躍,使爆炸,觸發
square=n.正方形,廣場,平方;adj.正方形的,四方的,直角的;adv.成直角地,正直地,公平地;v.使成方形,弄平
squirrel=n.松鼠;v.貯藏
stage=n.舞台,戲劇,活動場所,發展的進程,階段或時期,驛站;vt.上演,籌備,舉行
stamp=n.郵票,印花,印,圖章,標誌,印記,跺腳,頓足;v.跺(腳),頓(足),壓印
standard=n.旗,軍旗,標準,規格,本位;adj.標準的,權威,第一流的
steak=n.(供煎,烤等的)肉,魚,肉片,魚片,肉排,牛排
steal=v.偷,竊取,偷竊,偷盜
steam=n.蒸汽,水汽;vi.蒸發;vt.蒸
steel=n.鋼,鋼鐵
stick=n.棍,棒,手杖;v.粘住,粘貼;vt.刺,戳
stomach=n.胃,胃口,胃部;v.容忍
storm=n.暴風雨,暴風雪;v.狂怒咆哮;縮.Sensor,Tank,Off-Route Mine,路外反坦克雷傳感器
stove=n.爐
straight=adj.直的,誠實的,正直的,率直的,整齊的;adv.直,直接,一直
stranger=n.陌生人,門外漢
straw=n.稻草,麥杆
strawberry=n.草莓
stream=n.溪,川,流,一股,一串,河流;v.流,涌,流注
stress=n.重壓,逼迫,壓力,重點,著重,強調,重音;vt.著重,強調,重讀
stretch=v.伸展,伸長;n.一段時間,一段路程,伸展
strict=adj.(~ with) 嚴格的,嚴厲的,嚴謹的,精確的
strike=n.罷工,打擊,毆打;vt.打,撞擊,衝擊,罷工,打動,劃燃,到達;vi.打,打擊,罷工,抓,敲,搏動
string=n.線,細繩,一串,一行;v.排成一列
struggle=n.競爭,努力,奮鬥;vi.努力,奮鬥,掙扎;vt.盡力使得,使勁移動
subject=n.題目,主題,科目,學科;adj.受他國統治的,未獨立的,受制于…的,受…影響的;vt.使屈從于…,使隸屬
subtract=v.(~ from)減去,減
subway=n.地道,<美> 地鐵
succeed=vi.(~ in) 成功;v.繼…之後,繼任,繼承,取得成功
success=n.成功,成就,勝利,發跡,興旺
successful=adj.成功的
sudden=adj.突然的,意外的
suit=v.合適,適合,相配,合式,適宜于;n.一套衣服
sunny=adj.陽光充足的,照耀的,快樂的
supermarket=n.超級市場
supply=n.補給,供給,供應品;vt.補給,供給,提供,補充,代理;vi.替代他人職務
support=vt.支撐,扶持,支持,支援,擁護,維持,贍養,忍受;n.支撐,支持,支援,維持,贍養,支持者,支柱
surface=n.表面,外表,水面;adj.表面的,膚淺的
survive=v.幸免于,幸存,生還
swallow=n.燕子,吞咽,喉;vt.咽,淹沒,吞沒,取消,忍受,輕信,壓制,耗盡;vi.吞下,嚥下
swan=n.天鵝,傑出的詩人﹑歌手,天鵝座
sweater=n.厚運動衫,毛線衫
sweep=v.掃,打掃,清掃,席卷,沖光,掃過,掠過
swing=v.搖擺,擺動,迴轉,旋轉;n.鞦韆,搖擺,擺動
symbol=n.符號,記號,象征
table tennis=n.桌球
talent=n.天才,才幹,才能
talkative=adj.多話的,愛說話的,多嘴的
tangerine=n.橘子
tank=n.(盛液體,氣體的大容器)桶﹑箱﹑罐﹑槽,池塘,坦克,戰車,櫃;vt.儲于槽中,擊敗;vi.大量喝酒
tape=n.帶子,帶,錄音帶,磁帶;vt.錄音
target=n.目標,對象,靶子
task=n.任務,作業;v.分派任務
tasty=adj.好吃的,可口的;n.好吃的東西,吸引人的東西
team=n.隊,組
tear=n.破處,破縫,淚滴,眼淚,扯,飛奔;vi.流淚,撕破,猛沖,飛奔,被撕破;vt.扯,撕,撕破,戳破,拉掉
teen=n.悲哀,不幸,憤怒;vt.激怒,使煩惱;vi.煩躁,傷心
teenage=adj.十幾歲的
teenager=n.十幾歲的青少年
teens=n.十多歲
telephone=n.電話,電話機;v.打電話
television=n.電視,電視機,電機學,電視廣播事業
temple=n.廟,寺,神殿,教堂,禮拜堂,太陽穴,鬢角
tennis=n.網球運動;adj.網球的,用于網球運動的;vi.打網球
tent=n.帳篷
term=n.學期,期限,期間,條款,條件,術語
terrible=adj.很糟的,極壞的,可怕的,駭人的
terrific=adj.令人恐怖的
test=n.測試,試驗,檢驗;v.測試,試驗,檢驗
textbook=n.教科書,課本;adj.合乎規範的
theater=n.劇場,戲院,電影院,階梯教室,手術教室,手術室,全體觀眾,戲劇
therefore=adv.因此,所以
thick=adj.厚的,粗的,稠的,濃的;n.最擁擠部份,活動最多部份,事物的粗大濃密部份
thief=n.小偷,賊
thin=adj.薄的,細的,瘦的;vt.使變薄,使變細,使稀少;vi.變薄,變細,稀少;adv.薄地,稀疏地;n.細小部份
thirsty=adj.口渴的,渴望的,熱望的
throat=n.咽喉,喉嚨,嗓音,窄路,口子;vt.用喉音說,開溝于
through=介.穿過,通過,從開始到結束,經由,以;adv.從頭到尾,自始至終,直達地,徹底,完全;adj.直達的,直通的
throughout=介.遍及,貫穿;adv.到處,始終,全部
thumb=n.拇指;vt.以拇指撥弄,笨拙處理,弄壞,翻閱,作搭車手勢;vi.用拇指翻書頁
thunder=n.雷,雷聲,轟隆聲;vi.打雷,雷鳴
tip=n.頂,尖端,梢,傾斜;vt.在…頂端裝附加物,使傾斜,使翻倒,暗示;vi.傾斜,翻倒,傾覆;n.提示,技巧
title=n.頭銜,名稱,標題,冠軍,資格,字幕,權利,扉頁;vt.賦予頭銜,加標題于;adj.標題的,用作書名的
toast=n.烤麵包(片),吐司麵包,乾杯;vt.敬酒,烤(麵包等),使暖和;vi.烤暖,烤火,烘
toe=n.趾,腳趾;vt.以趾踏觸,用腳尖走;vi.動腳尖;縮.Tables of Organization and Equipment
tofu=n.(Jap.) 豆腐
toilet=n.盥洗室,梳洗
tomato=n.番茄,西紅柿
tongue=n.舌頭,舌狀物,語言,說話方式,口語;vt.舔,閑談,斥責;vi.吹管樂器
tooth=n.牙齒
topic=n.話題,主題
tour=n.旅行,遊歷,旅遊;v.旅行,遊歷,巡迴,漫游
towel=n.手巾,毛巾;v.用毛巾擦
tower=n.塔,城堡
track=n.軌跡,車轍,跟蹤,航跡,足跡,路,磁軌;vt.循路而行,追蹤,通過,用縴拉;vi.追蹤,留下足跡,走
trade=n.貿易,商業,交易,生意,職業,行業,信風,顧客;vi.交易,買賣,經商,對換,購物;vt.用…進行交換
tradition=n.傳統,慣例
traditional=adj.傳統的,慣例的,口傳的,傳說的
traffic=n.交通,通行,運輸,貿易,交通量,交易,交往,通信量;vi.交易,買賣;vt.在…通行,用…作交換
trap=n.圈套,陷阱,詭計,活板門,存水彎,汽水閘;vi.設圈套,設陷阱;vt.誘捕,誘騙,計捉,設陷,坑害
travel=v.旅行,傳播;vi.行進,傳播;n.旅行
treasure=n.財寶,財富,珍品,財產;vt.珍愛,珍惜,儲藏,珍藏
treat=n.宴請,款待,請客;vt.視為,對待,論述,治療,款待;vi.交涉,談判,協商,款待,作東
treatment=n.待遇,對待,處理,治療
trial=n.試驗,考驗,審訊,審判
triangle=n.三角形,三人一組,三角關係
trick=n.詭計,騙局,惡作劇,竅門,訣竅;vt.欺騙,哄騙
trousers=n.褲子,長褲
truck=n.卡車,敞棚貨車,(車站)搬行李用的手推車;vt.交易,交往;vi.駕駛卡車,以物易物;adj.<主美>運貨汽車的
trumpet=n.喇叭
trust=vt.信任,信賴,盼望,希望,賒賣,熱望,切望;n.(~ in) 信任,信賴
truth=n.事實,確實,真理,原理
tube=n.管,管子,地鐵,<美> 電子管,顯象管
tunnel=n.隧道,地道
turkey=n.火雞,無用的東西
turtle=n.海龜
TV=n.電視； Tuvalu ,圖瓦魯
type=n.類型,典型,模範,活字,鉛字;v.打字,測定(血等)類型
typhoon=n.颱風
ugly=adj.醜陋的,難看的
umbrella=n.傘,雨傘,庇護
underwear=n.內衣褲
uniform=adj.統一的,相同的,一致的,始終如一的,均衡的;n.制服;vt.使成一樣,使穿制服
upon=介.在…之上
upper=adj.上面的,上部的
used=adj.習慣的,舊的,用舊了的
used to=慣常,慣于
user=n.使用者,使用物,權利的實際享有
usual=adj.平常的,通常的,慣例的
vacation=n.假期,休假,(房屋等的)騰出;v.<美>度假,休假
valley=n.(山)谷,流域
value=n.價值,估價,評價,價格,值,確切涵義;vt.估價,評價,重視
victory=n.勝利,戰勝,克服,勝利女神
video=n.電視,錄象,視頻
village=n.鄉村,村莊;adj.村莊的
violin=n.小提琴,小提琴手
visitor=n.訪問者,來賓,遊客
vocabulary=n.詞彙,詞彙量,詞表
volleyball=n.排球
vote=n.投票,選票,表決,得票數;vi.投票;vt.投票,投票決定,公認,<口>建議,使投票
voter=n.投票者,有投票權者
waist=n.腰部,腰,衣服的上身部份,背心
waiter=n.侍者,服務員
waitress=n.女服務生
wake=vt.叫醒,激發;vi.醒來,醒著,警覺,振奮;n.醒,守夜,尾跡,(人,車等經過的)痕跡,守喪
wallet=n.皮夾,錢夾,釣魚帶
waterfall=n.瀑布,瀑布似的東西
watermelon=n.西瓜
wave=n.波,波浪,(揮手)示意,致意;vi.(揮手)示意,致意,波動,飄動,搖動
weapon=n.武器
wed=v.娶,嫁,結婚
weekday=n.週日,平日
western=adj.西的,西方的,來自西方的人,有西方特徵的
wet=adj.濕的,潮濕的,有雨的,多雨的;vt.弄濕
whale=n.鯨;v.捕鯨
whatever=代.凡是…,無論什麼;adj.無論怎樣的,無論哪一種的,什麼也
wheel=n.輪,車輪,輪子
whenever=連.無論何時,隨時;n.只要
wherever=adv.無論那裡,無論什麼情況下
whisper=n.耳語,私語,密談,謠傳,颯颯的聲音;vi.耳語,密談,颯颯地響;vt.低聲說
whoever=代.任何人,無論誰
widen=v.加寬,放寬,擴展
width=n.寬度,寬廣,廣博,有一定寬度的東西(如一快布料等)
wild=adj.野性的,野生的,野蠻的,狂熱的,瘋狂的
willing=adj.樂意的,自願的,心甘情願的,反應迅速的
windy=adj.有風的,颳風的,多風的,風強的,腹脹的,吹牛的
wing=n.翅,翅膀,翼,飛翔,機翼,派別;vt.裝以翼,飛過,使飛,空運,增加…速度;vi.飛,飛行
winner=n.勝利者,優勝者,獲勝的事物
wire=n.金屬絲,電線,電報,電信,鐵絲網;vt.用金屬絲捲起,拍電報;vi.打電報;adj.金屬絲制的
wise=adj.英明的,明智的,慎慮的,聰明的,博學的,明白的,賢明的;vi.知道;vt.告訴,勸導;n.方法,方式
within=n.內部,裡頭;adv.在內部,在內心裡;介.在…之內,不越出;adj.裡面的,內部的
without=介.沒有,不,(表條件)如果沒有,要沒有;adv.在外,在屋外
wolf=n.狼,殘忍貪婪之人,極度的窮困;vt.狼吞虎嚥,大吃;vi.獵狼
wonder=n.奇跡,驚奇,驚愕;vt.對…感到驚訝,驚奇,想知道;vi.驚訝,懷疑;adj.非凡的,奇妙的
wonderful=adj.令人驚奇的,奇妙的,極好的,令人愉快的
wooden=adj.木制的
wool=n.羊毛,毛織品,毛線,絨線,毛料衣物
worth=介.相當…價值;n.價值,財產;adj.值錢的,值的看中的
wound=n.創傷,傷口;vt.傷,傷寒;v.擊傷
yard=n.院子,碼
youth=n.青春,青年時期,初期,少年,青年們
zebra=n.斑馬
