black=黑色
white=白色
red=紅
yellow=黃
blue=藍色
green=綠色
pink=粉紅色
purple=紫色
brown=棕色
orange=橙
gray=灰色
coffee=咖啡
good=好
bad=壞
fine=好
big=大
small=小
cheap=便宜
expensive=昂貴
fresh=新
short=短
long=長時間
hard=嚴重
light=光
heavy=沉重
new=新
old=老
useful=有用
sweet=甜
pretty=漂亮
rich=富有
poor=貧窮
real=真正
strong=強大
weak=弱
thin=薄
right=是
wrong=錯誤
one=1
two=2
three=3
four=4
five=5
six=6
seven=7
eight=8
nine=9
ten=10
eleven=11
twelve=12
thirteen=13
fourteen=14
fifteen=15
sixteen=16
seventeen=17
eighteen=18
nineteen=19
twenty=20
thirty=30
forty=40
fifty=50
sixty=60
seventy=70
eighty=80
ninety=90
hundred=百
first=首先
second=第2
third=第3
fourth=第4
fifth=第5
sixth=第6
seventh=第7
eighth=第8
ninth=第9
tenth=第10
thousand=千
million=百萬
many=很多
much=很多
few=很少
little=很少
count=數
half=一半
kilogram=千克
pound=磅因
box=箱子
can=能
square=廣場
blind=盲
businessman=商人
worker=工人
farmer=農人
doctor=醫生
teacher=教師
writer=作家
boss=頭家
fisherman=漁夫
fire=火
place=安置
at=在
in=在裡
out=在外
on=在上
under=在下面
above=在上面
below=下面
near=近
beside=此外
between=在之間
along=沿
around=在周遭
front=正面
back=回來
behind=後
left=離開
east=東方
west=西方
south=南方
north=北方
into=進
circle=環繞
time=時間
morning=早上
noon=中午
afternoon=下午
evening=晚上
a.m.=上午
p.m.=下午
tonight=今晚
today=今天
tomorrow=明天
yesterday=昨天
week=周
Monday=星期一
Tuesday=星期二
Wednesday=星期三
Thursday=星期四
Friday=星期五
Saturday=星期六
Sunday=星期日
season=季節
spring=春天
summer=夏天
autumn=秋天
winter=冬天
year=年
month=月
hour=小時
minute=分鐘
o'clock=點
January=1月
February=2月
March=3月
April=4月
May=5月;可以
June=6月
July=7月
August=8月
September=9月
October=10月
November=11月
December=12月
now=現下
future=將來
past=過去
family=家庭
grandfather=祖父
grandmother=祖母
father=父親
mother=母親
aunt=姑母
uncle=叔叔
son=兒子
daughter=女兒
brother=兄弟
sister=姐妹
husband=丈夫
wife=妻子
baby=寶貝
child=孩子
boy=男孩
girl=女孩
born=天生
dead=死
age=年齡
young=年輕
bus=公共汽車
ticket=票
driver=司機
car=汽車
taxi=計程車
truck=卡車
bike=單車
street=街道
road=道路
train=訓練
station=車站
ship=船
boat=小船
plane=飛機
airport=飛機場
drive=開車
ride=乘
student=學生
school=學校
class=種類
classroom=教室
playground=運動場
Chinese=漢語
English=英語
history=歷史
art=藝術
music=音樂
blackboard=黑板
chalk=粉筆
book=書
dictionary=字典
ruler=統治者
eraser=橡皮擦
brush=刷子
pen=鋼筆
pencil=鉛筆
exercise=鍛鍊
notebook=筆記本
paper=紙
homework=家庭作業
pass=遞給
excellent=極好
weather=天氣
warm=溫暖
cool=涼爽
clear=清楚
cloudy=多雲
rainy=多雨
sunny=晴朗
windy=多風
ice=冰
wind=風
rain=雨
snow=雪
rainbow=彩虹
dry=乾燥
wet=潮濕
air=空氣
night=夜晚
space=空間
sky=天空
moon=月亮
star=星
sea=海
land=土地
food=食品
beef=牛肉
meat=肉
ham=火腿
fish=魚
egg=蛋
noodle=麵條
rice=大米
soup=湯
bread=麵包
butter=黃油
cheese=乳酪
hamburger=漢堡
pizza=披薩餅
hot dog=熱狗
sandwich=三明治
salad=沙拉
pie=餡餅
cake=蛋糕
candy=糖果
chocolate=巧克力
ice cream=冰淇淋
vegetable=菜蔬
tomato=番茄
fruit=水果
apple=蘋果
banana=香蕉
milk=牛奶
tea=茶
coke=焦炭
juice=汁
salt=鹽
sugar=糖
hot=熱
burn=燃燒
bowl=碗
glass=玻璃
cup=杯子
spoon=匙
chopsticks=筷子
fork=叉子
knife=刀
breakfast=早餐
lunch=午餐
dinner=晚餐
meal=飯
eat=吃
drink=喝
cook=煮
clothes=衣服
cap=帽子
hat=帽子
glove=手套
belt=帶子
shirt=襯衫
coat=外套
jacket=短上衣
sweater=毛線衫
skirt=裙子
dress=穿
uniform=相同
pants=褲子
shoe=鞋
wear=穿
change=漲跌
wash=洗
live=住
city=城市
house=房子
floor=地板
apartment=公寓
wall=牆
window=窗子
door=門
living room=起居室
bedroom=臥室
bed=床
bathroom=浴室
dining room=餐廳
kitchen=廚房
chair=椅子
sofa=沙發
desk=書桌
table=桌子
lamp=燈
carry=帶
like=相象
laugh=笑
smile=微笑
angry=忿怒
happy=愉快
exciting=令人激動
wonderful=令人驚嘆
bright=明亮
love=愛
kiss=吻
miss=錯過
agree=同意
hate=不喜歡
sad=悲哀
sorry=抱歉
cry=哭
afraid=害怕
worry=擔心
shy=怕羞
polite=有禮貌
cold=冷
funny=有趣
China=中國
America=美國
stay=停留
thank=感謝
map=地圖
beautiful=美麗
enough=足夠
famous=著名
check=買單
camera=照像機
restaurant=餐廳
hotel=飯店
pay=支付
beach=海灘
hill=小山
mountain=山
lake=湖
river=河
island=島
animal=動物
elephant=象
lion=獅子
tiger=虎
bear=忍受
monkey=猴子
mouse=老鼠
cat=貓
dog=狗
horse=馬
pig=豬
sheep=綿羊
goat=山羊
cow=母牛
rabbit=兔子
bird=鳥
chicken=雞肉
bee=蜜蜂
fly=飛
snake=蛇
tree=樹
grass=草
flower=花
rose=提升
noise=噪音
catch=抓住
water=水
meet=見面
hope=希望
help=幫助
excuse=原諒
idea=想法
ball=球
speak=講話
call=叫
number=數目
meeting=會議
visit=訪問
plan=計畫
free=免費
from=從
picnic=野餐
borrow=借
lend=借給
keep=保持
friend=朋友
telephone=電話
ring=戒指
line=線
phone=電話
video=錄像
e-mail=電子郵件
internet=網際網路
copy=複製
letter=信
piano=鋼琴
band=帶子
play=玩
blow=吹
club=俱樂部
sing=唱歌
dance=跳舞
television=電視
singer=歌手
zoo=動物園
park=公園
party=       聚會
able=能幹
about=大約
after=以後
again=再次
ago=以前
all=全部
almost=幾乎
already=已經
also=此外
American=美國人
an=A
and=並且
another=另一個
answer=回答
any=任何
anything=任何事情
arrive=到達
as=當時
ask=問
away=離開
bag=袋
basket=籃
basketball=籃球
because=因為
before=以前
bell=鈴
bicycle=單車
birthday=生日
body=身體
both=兩
bottle=瓶子
bridge=橋
business=商務
busy=忙
but=但是
by=透過
card=卡片
care=關心
classmate=同班同學
clean=清潔
clock=鐘
close=關閉
come=來
cost=花費
country=國家
cover=蓋住
cross=穿過
cut=切
dad=爸爸
dangerous=危險
dark=黑
date=日期
dear=親愛的
decide=決定
delicious=好極了
die=死
different=不同
difficult=難
dirty=臟
dollar=美元
down=向下
draw=拉
during=在期間
each=每一個
ear=耳朵
early=早
earth=地球
easy=容易
either=兩者其一
end=結束
enjoy=喜愛
even=即使
ever=曾經
every=每
everything=一切
except=把除外
eye=眼睛
face=臉
fact=事實
factory=工廠
fan=球迷
fill=充滿
follow=跟隨
for=因為
foreign=外國
friendly=友好
full=充分
fun=娛樂
game=遊戲
garden=花園
give=給
glad=高興
go=去
goodbye=再見
grade=等級
great=大
ground=地
group=團體
hair=頭髮
hand=手
happen=發生
he=他
head=頭
healthy=健康
heart=心
hello=你好
here=這裡
hers=她的
herself=她自己
hi=喂
high=高
him=他
himself=他自己
his=他的
holiday=假期
home=主頁
hospital=醫院
how=怎樣
hungry=飢餓
hurry=趕快
I=I
if=如果
important=重要
inside=在裡面
it=它
join=參加
jump=跳
just=只不過
key=鑰匙
kind=友好
knock=敲
language=語言
large=大
last=收盤
late=後來
later=稍後
lazy=懶惰
learn=學習
leg=腿
lesson=課
let=讓
library=圖書館
lie=謊話
life=生活
list=目錄
listen=聽著
look=看
loud=響亮
low=低
machine=機器
make=做
matter=事情
market=市場
mathematics=數學
maybe=或許
me=我
medicine=藥
mind=介意
mine=我的
mistake=錯誤
modern=現代
moment=片刻
money=錢
most=最
move=移動
museum=博物館
must=必須
my=我的
myself=我自己
name=名字
need=需要
never=決不
news=新聞
nice=好
no=不
nobody=沒人
nose=鼻子
not=不
nothing=沒有什麼
nurse=護士
of=的
off=離開
office=辦公室
often=經常
once=一次
only=只
open=打開
or=或者
other=其他
our=我們的
ours=我們的
ourselves=我們自己
outside=在外面
over=在上方
own=擁有
page=頁
pair=對
parent=父母
people=人
perhaps=或許
person=人
pick=挑
picture=圖
piece=片
please=請
police=警察
popular=受歡迎
possible=可能
practice=實踐
problem=問題
pull=拉
push=推
put=放
question=問題
quick=快
quiet=安靜
quite=完全
radio=廣播
read=讀
ready=準備好
really=真的
remember=記得
rest=休息
room=空間
round=環形
same=相同
save=保留
seat=位子
serious=嚴肅
several=幾個
show=顯示
sick=生病
side=邊
since=後來
sir=先生
size=尺寸
slow=慢
so=因此
some=一些
something=某些事情
song=歌
soon=不久
start=開始
still=仍然
stop=停止
story=故事
study=研究
sun=太陽
sure=當然
talk=交談
tall=高
team=隊
test=測試
that=那
the=這
their=他們的
theirs=他們的
them=他們
themselves=他們自己
there=那裡
these=這些
they=他們
thing=事情
this=這
those=那些
to=對
too=也
town=鎮
trouble=麻煩
try=試驗
turn=轉動
until=直到
up=向上
us=我們
use=使用
usually=通常
very=非常
wait=等待
walk=走
want=想要
watch=表
way=模式
we=我們
welcome=歡迎
well=好
what=什麼
when=什麼時候
where=在那裡
whether=是否
which=哪個
who=誰
whose=誰的
why=為什麼
will=將
wish=希望
without=沒有
woman=婦女
word=話
work=工作
world=世界
yes=是的
yet=然而
you=你
your=你的
yours=你的
yourself=你自己
airplane=飛機
although=雖然
am=上午
appear=出現
arm=臂
bank=銀行
bath=洗澡
believe=相信
belong=屬於
block=塊
bottom=底部
camp=陣營
case=情況
celebrate=慶祝
cent=分
cheer=乾杯
church=教堂
climb=攀登
collect=收集
common=普通
computer=計算機
convenient=方便
mean=意味著
next=下一步
nod=點頭
ruin=毀壞
sentence=句子
sound=聲音
teenager=青少年
hurt=傷害
present=提出
share=分享
smell=聞出
her=她的
she=她
a few=一些
a little=稍微
a lot=很多
always=總是
anyone=任何人
anybody=任何人
fall=下降
bakery=麵包房
tooth=牙齒
towel=毛巾
toy=玩具
traffic=交通
typhoon=颱風
umbrella=傘
understand=理解
unhappy=不開心
USA=美國
waiter=服務生
waitress=女侍者
wake=醒來
win=贏
workbook=輔助練習冊
write=寫
yeah=是的
correct=正確
could=能
cousin=堂兄弟
dish=盤子
dozen=打
drop=下降
else=其他
enter=進入
example=例子
excited=令人激動
fat=肥胖
find=發現
finger=手指
finish=完成
fix=修理
gift=禮物
guess=猜猜
habit=習慣
handsome=漂亮
headache=頭痛
health=健康
heat=熱
hit=撞擊
hobby=嗜好
honest=誠實
however=但是
interest=使感興趣
is=是
its=它的
itself=它自己
job=工作
joy=快樂
kick=踢
kill=殺死
king=國王
kite=風箏
knee=膝
knowledge=知識
lead=引起
lip=唇
lonely=孤單
mail=郵件
mailman=郵差
menu=選單
might=可以
mile=英里
more=更多
national=國家
neck=脖子
notice=通知
officer=官員
oil=油
order=預訂
pack=包裝
paint=油漆
pet=寵物
point=分
pork=豬肉
postcard=明信片
prepare=準備
price=價格
proud=驕傲
public=公眾
queen=王后
refrigerator=雪櫃
repeat=重複
rule=規章
safe=安全
sale=銷售
seldom=很少
shape=形狀
shop=商店
should=應該
shoulder=肩
simple=簡單
smart=漂亮
smoke=吸煙
somewhere=在某處
special=特別
stomach=胃
store=商店
strange=奇怪
stranger=陌生人
stupid=愚蠢
successful=成功
surprise=驚奇
tape=帶子
taste=品嘗
tennis=網球
than=比
then=那時
thirsty=口渴
though=可是
tired=疲倦
together=一同
touch=接觸
trip=旅行
vacation=假期
voice=聲音
weekend=週末
wise=聰明
with=由於
would=將
chance=機會
crazy=發瘋
experience=經驗
mark=標明
baseball=棒球
be=是
are=是
was=是
were=是
been=是
become=變得
begin=開始
bite=咬
bookstore=書局
bore=有
boring=令人厭煩
break=毀壞
bring=帶來
build=建造
buy=買
careful=小心
cell phone=手機
center=中心
cheat=欺騙
Christmas=耶誕節
color=顏色
comfortable=舒適
comic=諧劇
couch=睡椅
cute=伶俐
department store=百貨公司
dig=挖
do=做
does=做
did=做
done=做
Dr.=博士
doll=玩偶
dream=夢
elementary school=國小
eve=前夜
everyone=每人
everybody=每人
fast=迅速
daddy=爸爸
favorite=最喜愛
feel=感到
festival=節日
finally=最後
foot=腳
foreigner=外國人
forget=忘記
garbage=廢料
gas=氣體
get=拿到
good-bye=再見
bye=再見
grandpa=爺爺
grandma=奶奶
grow=增長
hard-working=勤奮
have=有
hear=聽到
helpful=有幫助
hide=隱藏
hold=拿
interested=使感興趣
interesting=有趣
jeans=牛仔褲
jog=慢跑
junior high school=國中
kid=兒童
know=知道
leader=領導人
least=最小
leave=離開
lemon=檸檬
less=較少
lose=失敗
lucky=運氣好
magic=魔術
mail carrier=郵件搬運工
man=人
married=結婚
math=數學
medium=媒介
mom=媽媽
mommy=媽媽
motorcycle=機車
mouth=嘴
movie=電影
Mr.=先生
Mrs.=太太
Ms.=女士
OK=沒問題
package=包
part=部分
physical education=體育
player=運動員
popcorn=玉米花
post office=  郵局
program=計畫
railway=鐵路
restroom=洗手間
ROC=ROC
run=跑
say=說
see=看見
sell=出售
send=送
senior high school=高中
shall=將
shopkeeper=店主
sidewalk=行人穿越道
sit=坐
sleep=睡
snack=快餐
socks=短襪
someone=有人
somebody=某人
sometimes=有時
spell=拼寫
spend=花費
farm=農場
sports=體育
stand=站
steak=牛排
supermarket=超市
surprised=驚訝
swim=游泳
Taiwan=台灣
take=帶
teach=教
tell=告訴
theater=劇院
think=認為
silver=銀
metal=金屬
plastic=塑膠
plus=另
minus=負號
meter=米
centimeter=厘米
dumb=啞
policeman=警察
lawyer=律師
servant=僕人
housewife=家庭主婦
sailor=海員
salesman=售貨員
scientist=科學家
universe=宇宙
rectangle=長方形
curve=曲線
nephew=侄子
niece=姪女
grandson=孫子
granddaughter=孫女
jeep=吉普車
subway=地下鐵
ambulance=救護車
traffic lights=交通燈
traffic jam=交通堵塞
highway=公路
bus stop=公車站
railroad=鐵路
platform=平台
submarine=潛水艇
helicopter=直升飛機
principal=主要
gym=體育館
geography=地理
triangle=三角形
pencil box=鉛筆盒
glue=膠
quiz=測驗
foggy=有霧
snowy=雪白
lightning=閃電
thunder=雷
fog=霧
waterfall=瀑布
mud=泥漿
turkey=火雞
dumpling=餃子
French fries=薯條
dessert=甜點心
cabbage=洋白菜
potato=馬鈴薯
grape=葡萄
soda=蘇打
vinegar=醋
pepper=胡椒
sour=酸
saucer=茶托
swallow=燕子
scarf=圍巾
blouse=短衫
T-shirt=T恤
vest=背心
pajamas=睡衣褲
shorts=短褲
needle=針
throw=投
village=村莊
neighbor=鄰居
building=建造
stairs=樓梯
downstairs=樓下
roof=屋頂
balcony=陽台
basement=地下室
mat=墊席
pillow=枕頭
armchair=扶手椅
bookcase=書箱
hanger=吊架
air conditioner=空調
washing machine=洗衣機
pleased=高興
complain=抱怨
horrible=可怕
naughty=頑皮
Australia=澳洲
Britain=英國
Canada=加拿大
France=法蘭西
Germany=德國
Italy=義大利
Japan=日本
Korea=朝鮮
Singapore=新加坡
cash=現金
negative=負
purse=錢包
male=男性
kangaroo=大袋鼠
panda=熊貓
wolf=野狼
hippo=河馬
bat=蝙蝠
pigeon=鴿子
goose=鵝
insect=昆蟲
ant=螞蟻
mosquito=蚊子
whale=鯨魚
shark=鯊魚
frog=蛙
pollution=污染
social=社會
custom=風俗
manner=模式
shake=搖晃
receive=收到
TV=電視
drum=敲打
flute=長笛
guitar=吉他
violin=小提琴
trumpet=喇叭
abroad=在國外
absent=缺席
accident=事故
alike=一樣
assume=以為
behave=表現
bitter=    苦
bother=打擾
burst=爆發
charge=收費
coach=教練
command=命令
confident=自信
confuse=干擾
contract=合約
damage=損壞
debate=辯論
decorate=裝飾
deliver=交付
direct=直接
doubt=懷疑
employ=雇用
environment=環境
express=表示
fit=適合
focus=集中
former=以前
gain=獲得
general=一般
generous=慷慨
greedy=貪婪
handle=處理
humble=謙遜
imagine=想像
influence=影響
inspire=鼓舞
instant=立即
interrupt=打斷
interview=接見
jam=果醬
jealous=妒忌
judge=判斷
limit=限制
mask=面罩
maximum=最大
minor=較小
note=注意到
object=物體
offer=提供
omit=忽略
partner=合伙人
pause=暫停
provide=提供
puzzle=謎
quit=辭職
raise=提升
reject=拒絕
relative=有關
rent=租金
sample=樣品
score=得分
screen=螢幕
serve=提供
sign=簽字
similar=相似
strike=罷工
succeed=成功
suit=衣服
survive=倖存
symbol=代碼
through=全面
trace=蹤跡
treat=對待
unique=獨特
value=估價
wound=傷口
in front of=在的前面
next to=僅次於
both ~ and=A和B
get off=下車
get on=快點
as well as=以及
a lot of=許多
as if=好像
as soon as=一就
either xxx or=或者xxx或者
even if=即使
out of=在之外
not only xxx but also=不僅xxx而且
neither xxx nor=兩xxx都不也非
action=行動
activity=活動
adult=成年人
affect=影響
AIDS=愛滋病
alarm=警報
alarm clock=鬧鐘
album=專輯
alphabet=  字母
ancient=古老
ankle=踝
appreciate=感激
arrange=安排
Asia=亞洲
avoid=避免
baby sitter=保母
badminton=羽球
barber=理髮師
bark=狗叫
bean=豆
beard=胡子
beginning=開始
being=是
bicycle riding=騎單車
blank=空白
bomb=炸彈
primary school=國小
bowling=保齡球
boyfriend=男朋友
brick=磚
brunch=早午餐
buffet=打擊
bug=缺陷
bun=小圓甜麵包
bundle=包
burger=漢堡包
butterfly=蝴蝶
cable=電報
cafeteria=自助餐廳
calendar=日曆
camping=露營
campus=大學校園
Canadian=加拿大人
cancel=  取消
cancer=癌症
careless=粗心
cassette=盒子
CD=CD
CD player=CD播放器
cereal=穀類
channel=海峽
character=性格
chase=追趕
cheerleader=啦啦隊長
chemical=化學
chess=西洋棋
childish=孩子氣
childlike=孩子似
chin=下巴
Chinese New Year=春節
chubby=豐滿
clap=  鼓掌
class leader=班長
classical=古典
climate=氣候
climbing=攀登
closet=櫥柜
cockroach=蟑螂
comment=意見
computer game=電動
contact lens=隱形眼鏡
convenience store=便利商店
cooking=烹飪
court=法庭
crab=蟹
create=建立
credit card=信用卡
crime=犯罪
crowded=擁擠
culture=文化
culture center=文化中心
dancing=跳舞
dentist=牙科醫生
department=部門
detect=偵測
dial=撥
diligent=勤勉
disappear=消失
dishonest=  不誠實
dizzy=眩暈
dodge ball=躲避球
dolphin=海豚
donkey=驢
dot=小圓點
Double Tenth Day=雙十節
doughnut=甜甜圈
dragon=龍
Dragon-boat Festival=端午節
drama=戲劇
drawer=抽屜
dresser=碗櫃
drugstore=藥局
dryer=吹風機
earrings=耳環
Easter=復活節
eighteenth=第18
elect=選舉
emotion=情感
emphasize=強調
engine=  引擎
pencil case=鉛筆盒
England=英國
Englishman=英國人
error=錯誤
Europe=歐洲
evil=邪惡
exercising=鍛鍊
eyebrow=眉
far=遠
fast food=快餐
fast food restaurant=速食店
faucet=水龍頭
feeling=感情
fifteenth=第15
fire station=消防隊
fishing=捕魚
flashlight=閃光燈
flat tire=爆胎
flight=航機
flour=麵粉
flower shop=花店
flu=流行性感冒
forgive=原諒
fourteenth=第14
frank=坦率
freedom=自由
freezer=冷凍庫
freezing=結冰
fried chicken=炸雞
fried rice=炒飯
Frisbee=飛盤
gas station=加油站
gesture=手勢
ghost=鬼
glasses=眼鏡
golf=高爾夫球
goodness=善良
grow up=發展
guava=芭樂
guy=小伙子
hairdresser=理髮師
Halloween=萬聖節
hammer=鐵錘
heater=發熱器
hey=喂
hiking=徒步旅行
hip=時髦
homesick=想家
honesty=誠實
honey=蜂蜜
Hong Kong=香港
hop=跳躍
host=主人
humid=潮濕
humor=幽默
humorous=幽默
hunt=打獵
hunter=獵人
impolite=沒禮貌
independent=獨立於
instant noodle=速食麵
instrument=儀器
intelligent=聰明
invent=發明
invitation=邀請
jazz=爵士樂
jogging=慢跑
journalist=記者
Kaohsiung=高雄
ketchup=番茄醬
kindergarten=幼稚園
kingdom=王國
kitten=小貓
kitty=小貓
koala=考拉
Korean=朝鮮語
KTV=KTV
lack=缺乏
lady=女士
lamb=羔羊
Lantern Festival=元宵節
lay=放置
LD=LD
lettuce=萵苣
lid=蓋子
link=連接
liquid=液體
loaf=麵包
local=當地的
locker=貯物櫃
London=倫敦
loser=輸家
lychee=荔枝
ma'am=太太
magician=魔術師
mall=購物中心
Mandarin=國語
mango=芒果
marker=記分員標誌
mechanic=技工
men's room=男盥洗室
microwave=微波爐
Mid-Autumn Festival=中秋節
milk shake=奶昔
mirror=鏡子
missing=丟失
monster=怪物
moon cake=月餅
Mother's Day=母親節
motion=運動
mountain-climbing=爬山
movie star=影星
movie theater=電影院
MRT=捷運
MTV=音樂電視
Musician=音樂家
napkin=餐巾
necklace=項鍊
nest=巢
New Year's Day=元旦
New York=紐約
nineteenth=第19
oh-oh=噢，噢
onion=洋蔥
oops=哎呀
outer space=外太空
oven=烤爐
overpass=天橋
overseas=海外
over-weight=超重
owner=擁有人
ox=公牛
painful=痛苦
painter=畫家
papaya=木瓜
Paris=巴黎
parking lot=停車場
parrot=鸚鵡
paste=粘貼
peach=桃子
Philippines=菲律賓
pineapple=鳳梨
poison=毒
police officer=警官
police station=警察局
pollute=污染
pond=池塘
pop music=流行音樂
positive=積極
pray=祈禱
priest=神父
primary=主要
prince=王子
princess=公主
private=私人
project=工程
pump=幫浦
pumpkin=南瓜
puppy=小狗
rare=稀有
rat=老鼠
reading=閱讀
realize=意識到
recover=恢復
responsible=負責任
revise=修正
rise=提升
rob=搶劫
robot=機器人
roller skating=滾輪溜冰
rope=繩
rub=擦
rubber band=橡皮筋
rude=粗魯
running=跑
running nose=流鼻水
Russia=俄羅斯
sailing=帆船運動
scared=驚嚇
schoolmate=同學
seafood=海鮮
secondary=第二
section=部分
seesaw=蹺蹺板
select=選擇
selfish=自私
semester=學期
seventeenth=第17
shelf=架子
shine=發亮
shoes=鞋
shopping=購物
shrimp=蝦
sincere=誠實
singing=唱歌
sink=下沉
sixteenth=第16
skating=滑冰
skiing=滑雪
skinny=削瘦
slender=細長
slide=滑動
slim=苗條
slippers=拖鞋
snail=蝸牛
sneakers=橡皮底帆布鞋
sneaky=劣酒
snowman=雪人
soccer=足球
social science=社會科學
softball=壘球
solve=解決
sore throat=喉嚨痛
soy-sauce=醬油
spaghetti=義大利面
speaker=發言者
spider=蜘蛛
stamp collecting=集郵
stationery store=文具店
steal=偷
stingy=吝嗇
stomachache=胃痛
stormy=暴風雨
stove=爐
straw=稻草
strawberry=草莓
stream=溪
style=風格
surfing=  滑水
swan=天鵝
sweep=掃
swimsuit=泳衣
swing=搖擺
table cloth=桌布
table tennis=桌球
Taichung=台中
Tainan=台南
Taipei=台北
Taiwanese=台灣人
talkative=喜歡說話
tangerine=蜜柑
tank=油箱
tape recorder=錄音機
Teacher's Day=教師節
teapot=茶壺
temple=廟
textbook=教科書
Thanksgiving Day=感恩節
thirteenth=第13
thought=認為
throat=喉嚨
thumb=拇指
tidy=整潔
tiny=極小
title=標題
toast=  土司
toe=腳趾
tofu=豆腐
toilet=洗手間
tool=工具
toothbrush=牙刷
topic=題目
toward=對於
tradition=傳統
traditional=傳統的
traffic light=交通燈
train station=火車站
trap=陷阱
trash can=垃圾桶
traveling=旅行
treasure=財寶
trousers=褲子
tub=澡盆
tummy=肚子
tunnel=隧道
turtle=海龜
uh-uh=噢噢
underlie=為…基礎
underpass=地下道
underwear=內衣
under-weight=在重量下
unfriendly=不友好
Valentine's Day=情人節
VCR=卡式錄放影機
vocabulary=詞彙
volleyball=排球
vote=投票
waist=腰
walkman=隨身聽
wallet=錢包
waste=浪費
watermelon=西瓜
winner=獲勝者
women's room=女廁
woods=樹林
worried=擔心
wow=哇
wrist=手腕
yucky=厭惡的行為
yummy=好吃的
zebra=斑馬
adjective=形容詞
adverb=副詞
airmail=航空郵寄
alley=巷
anyway=無論如何
auxiliary=輔助的
beautifully=好極了
besides=而且
carefully=仔細
certainly=當然
children=孩子
Christmas Eve=平安夜
comfortably=舒適
connective=連接
cookies=甜餅乾
determiner=確定
drinks=喝
extra large=特大
family name=姓
first grade=ㄧ年級
first name=名字
food restaurant=餐廳
generally=通常
get in=進入
given name=名字
gloves=手套
good looking=好看
grapefruit=葡萄柚
in back of=在後面
indefinite=非限定
jar=罐子
lane=小路
last name=姓
location=位置
Los Angeles=洛杉磯
lunch box=便當
measurement=測量
microwave oven=微波爐
nationality=國籍
necktie=領帶
nice looking=好看
ninetieth=第90
noodles=麵條
occupation=頭班
photo=照片
pingpong=桌球
possessive=佔有欲強
preposition=介詞
product=產品
pronoun=代名詞
reading test=閱讀試驗
reflexive=反向
Rome=羅馬
San Francisco=舊金山
second grade=二年級
skate=滑冰
ski=  滑雪
soft drink=汽水
tableware=餐具
Tokyo=東京
traffic sign=交通標誌
transportation=交通
typewriter=打字機
weekday=工作日
wood=木頭
Youth Day=青年節
address=位址
against=對抗
alone=單獨
blanket=毯子
boil=沸騰
bone=骨頭
bow=弓
brain=大腦
branch=分部
brave=勇敢
broad=寬
broadcast=廣播
bucket=水桶
cage=籠
calm=平靜
candle=蠟燭
captain=隊長
carpet=地毯
carrot=胡蘿蔔
castle=城堡
ceiling=天花板
clerk=辦事員
clever=聰明
cloth=布
clothing=衣服
coin=硬幣
college=學院
comb=梳子
company=公司
compare=比較
complete=完成
congratulation=恭喜
consider=考慮
continue=繼續
control=控制
conversation=談話
corn=穀物
cough=咳嗽
couple=ㄧ對
courage=勇氣
cream=奶油
crowd=人群
cruel=殘忍
cure=治愈
curious=奇特
curtain=窗帘
customer=用戶
danger=危險
deaf=聾
death=死
decision=決定
deer=鹿
degree=度
depend=依靠
desert=拋棄
design=設計
desire=想要
develop=發展
diamond=鑽石
diary=日記
difference=差別
difficulty=困難
direction=方向
discover=發現
discussion=討論
distance=距離
double=加倍
downtown=商中心
drawing=畫
earn=掙
elder=年長
electric=電
electricity=電
eleventh=第11
enemy=敵人
energy=能量
engineer=工程師
entrance=入口
envelope=信封
especially=特別是
event=活動
excite=令人激動
expect=期望
explain=解釋
extra=額外
fair=公正
fault=錯誤
fear=懼怕
feather=羽毛
fence=圍牆
fever=發燒
final=最後
fight=戰鬥
fool=傻瓜
foolish=愚蠢
forest=森林
form=形式
fox=狐狸
French=法語
frighten=嚇住
garage=車庫
gentle=溫和
gentleman=紳士
geographical=地理
German=德語
girlfriend=女朋友
goal=目標
god=神
gold=黃金
golden=金色
government=政府
greet=迎接
guard=警衛
guest=客人
guide=向導
gun=槍
hall=大廳
handkerchief=手絹
height=高度
hen=母雞
hero=英雄
hire=租用
housework=家事
human=人
hunger=飢餓
impossible=不可能
improve=改進
inch=英寸
include=包括
ink=墨水
international=國際
introduce=介紹
invite=邀請
iron=鐵
joke=笑話
law=法律
lock=鎖
lovely=可愛
mad=發狂
magazine=雜誌
main=主要
manager=經理
marry=結婚
mass=群眾
meaning=意思
method=方法
midnight=午夜
mix=混合
model=模型
movement=運動
nail=釘子
narrow=狹窄
nation=國家
natural=自然
nature=自然
nearly=幾乎
necessary=必要
nervous=神經
noisy=嘈雜
obey=服從
ocean=海洋
oh=噢
among=在中
anger=憤怒
bill=賬單
choose=選擇
cotton=棉花
course=課程
deep=深
duck=鴨子
everywhere=到處
exam=考試
fail=失敗
film=電影
football=足球
gate=門
hardly=幾乎沒有
ill=病
Japanese=日語
lift=舉起
lot=場地
member=成員
message=消息
neither=兩個都不
newspaper=報紙
none=沒有一個
nor=也非
nut=堅果
oneself=自己
pardon=原諒
pear=梨
plant=植物
plate=盤子
quarter=四分之一
quickly=迅速
rather=相反
science=科學
seem=好像
shout=大叫
soldier=士兵
sport=體育
stamp=郵票
such=這些
swimming=游泳
temperature=溫度
term=時期
travel=旅行
twelfth=第12
twentieth=第20
usual=通常
verb=動詞
visitor=參觀者
while=當時
whole=整個
whom=誰
wide=寬
wild=狂熱
zero=零
accept=接受
across=透過
act=行動
active=活躍
actor=演員
actress=女演員
advice=建議
advise=建議
ahead=在前面
aim=瞄準
alive=活著
allow=允許
altogether=完全
anywhere=任何地方
area=地區
artist=藝術家
asleep=睡著
assistant=助手
attack=攻擊
awake=醒來
bake=烤
beat=打
beer=啤酒
bench=長凳
operation=操作
opinion=意見
ordinary=普通
pain=痛苦
pale=蒼白
pan=鍋
passenger=乘客
path=道路
patient=病患
pattern=圖案
peace=和平
peaceful=和平
perfect=完美
period=時期
personal=個人
photographer=攝影師
pile=堆
pin=別針
pipe=管
plain=明白
pleasant=愉快
pleasure=快樂
pocket=口袋
poem=詩
pool=水池
population=人口
port=港口
pot=罐
power=能力
praise=稱揚
precious=寶貴
president=總統
print=列印
probably=或許
produce=生產
production=生產
progress=發展
promise=許諾
pronounce=宣佈
protect=保護
punish=處罰
purpose=目的
raincoat=雨衣
reason=原因
record=記錄
refuse=拒絕
regret=遺憾
remind=提醒
repair=修理
respect=尊重
review=評論
rubber=橡膠
rush=沖
safety=安全
sail=航行
sand=沙
satisfy=滿足
satisfied=滿足
search=搜索
secret=祕密
secretary=秘書
service=服務
sheet=褥單
shore=  岸
shower=  陣雨
shut=關閉
silence=寂靜
silent=寂靜
silly=傻
single=單身
skill=技能
skin=皮
soap=肥皂
society=社會
speech=講話
spirit=精神
steam=蒸汽
storm=風暴
straight=直
success=成功
successfully=成功
sudden=突然
suddenly=突然
suitcase=提箱
supper=晚飯
tail=尾巴
tear=眼淚
tent=帳篷
terrible=可怕
thick=濃
thief=賊
thirtieth=第30
tie=绑
till=直到
tongue=舌頭
toothache=牙痛
tower=塔
trade=貿易
trust=相信
truth=事實
type=打字
ugly=醜陋
upon=在上面
upstairs=樓上
valley=山谷
valuable=有價值
victory=勝利
war=戰爭
wave=波
wedding=婚禮
weight=重量
wheel=車輪
wing=翅膀
yard=院子
youth=年青人
abandon=拋棄
abbey=艾比
ability=能力
aboard=在上面
accelerate=加速
accent=口音
acceptance=接受
access=進入
accidental=偶然
accommodation=住宿
accomplish=完成
accustomed=習慣
ache=疼
achieve=取得
achievement=成就
acid=酸
acknowledge=承認
addition=增加
additional=另外
adequate=足夠
adjust=調整
administration=管理
administrative=管理
admit=承認
adopt=採用
advance=發展
advanced=進階
afford=給予
African=非洲人
afterwards=後來
aged=變舊
agency=代理
agenda=議程
agriculture=農業
aid=幫助
aircraft=飛機
airline=航空公司
albeit=雖然
anchor=拋錨
angle=角度
anniversary=週年紀念日
applicant=申請人
application=應用
apply=使用
Arab=阿拉伯人
arbitrary=任意
archbishop=大主教
artistic=藝術
ash=灰
ashamed=慚愧
atom=原子
audio=音頻
ax=砍
aye=贊成
background=背景
backing=回來
backward=落後
bacon=咸肉
base=基礎
basic=基本
basically=基本上
basin=盆
basis=基礎
berry=漿果
best=最好
bet=打賭
bleed=出血
blend=調和
blew=吹
bought=買
bounce=彈回來
bulk=體積
bullet=子彈
bump=  碰
cab=  計程車
cabin=小屋
cabinet=櫥
calculate=計算
came=來
cart=車
cartoon=漫畫
cashier=出納員
cast=投
centigrade=度
central=中心
century=世紀
ceremony=典禮
certain=肯定
characterize=描述
charity=慈善
charm=魅力
chart=圖表
charter=特許証
chat=聊天
cheek=面頰
chill=寒意
chimney=煙囪
chip=片
choice=選擇
choke=阻塞
cite=引用
citizen=公民
civic=市政
civil=市民
clause=條款
claw=爪
clay=黏土
clearing=清除
clerical=文書
click=點擊
coarse=粗糙
coast=海岸
cock=公雞
combine=結合
comedy=諧劇
comfort=使緩和
commerce=商業
compass=指南針
compel=強迫
compete=競爭
competent=有能力
compress=壓縮
comprise=包括
compromise=妥協
comrade=同志
counter=柜台
courtyard=院子
credit=信貸
crop=莊稼
authority=權力
auto=汽車
automobile=汽車
available=可提供
daily=每天
damp=潮濕
dare=敢
dawn=黎明
day=天
deal=預定
declare=宣佈
deed=行為
defeat=戰勝
defend=保護
defense=防禦
delay=延遲
delight=使高興
demand=要求
depth=深度
describe=描述
description=描述
destroy=破壞
determine=確定
devote=奉獻
dialogue=對話
dictation=口授
director=主管
disappoint=失望
discuss=討論
disease=疾病
distant=遠
district=地區
divide=分
drank=喝
drew=拉
drill=操練
driving=開車
drove=迫使
drown=淹死
drug=醫藥
due=到期
dug=挖
dull=黯淡
dust=灰塵
duty=職責
dying=死
eager=渴望
eastern=東方
edge=邊緣
education=教育
effect=影響
effort=努力
empty=空
encourage=鼓勵
entire=整個
equal=相等
equipment=設備
escape=逃走
European=歐洲人
exact=精確
examination=檢查
examine=檢查
exhibition=展覽會
exist=存在
experiment=實驗
explanation=解釋
expression=表示
faith=信任
false=錯誤
familiar=熟悉
favor=支援
feet=腳
fell=下降
fellow=人
felt=感到
fetch=拿
field=領域
figure=數字
firm=堅定
fist=拳頭
flag=旗
flat=平
flew=飛
float=漂浮
flood=洪水
flow=流動
fold=摺疊
fond=喜歡
force=力量
forestry=林學
forever=永遠
fortunate=幸運
fortune=命運
forward=前言
fought=戰鬥
found=發現
fountain=泉水
freeze=結冰
frequent=頻繁
fridge=雪櫃
froze=結冰
fuel=燃料
furniture=家具
gather=收集
gave=給
gay=快活
geese=鵝
generation=代
glance=看一眼
got=拿到
grew=增長
hang=懸掛
happiness=愉快
harvest=斬獲
headmaster=校長
held=拿
hole=洞
honor=榮譽
huge=巨大
hung=懸掛
illness=病
immediate=立即
income=收入
increase=增加
indeed=的確
information=訊息
insist=堅持
instead=相反
instruction=指示
journey=旅行
kilometer=公里
knew=知道
labor=勞動
ladder=梯子
laid=放
lately=最近
leaf=葉
league=聯盟
lecture=演講
led=引起
length=長度
level=水準
lifetime=一生
load=裝
loss=損失
lost=失敗
luck=運氣
madam=夫人
made=做
major=主要
majority=多數
manage=管理
marriage=結婚
master=主人
match=比賽
material=材料
meanwhile=同時
measure=測量
memory=記憶
mend=修理
mental=精神
mention=提及
midday=正午
middle=中間
mineral=礦物質
monitor=顯視器
motor=電動機
murder=謀殺
native=本地
neat=整潔
net=網
noble=貴族
normal=正常
northern=北方
nowadays=現下
occur=發生
official=官員
okay=好
onto=到上
operate=操作
organize=工具
otherwise=否則
ought=應該
outdoor=戶外
overcoat=大衣
owe=欠
packet=包
paid=支付
palace=宮殿
particular=特別
partly=部分
passage=通路
peasant=農民
penny=便士
per=每
percent=百分之
perform=執行
permit=允許
persuade=說服
photograph=照片
pilot=飛行員
pioneer=  先鋒
pity=憐憫
plenty=大量
plough=犁
plow=犁
poet=詩人
pole=杆
political=政治
politics=政治
position=位置
possession=擁有
post=公佈
pour=倒
practical=實際
prefer=更喜歡
press=壓
pretend=假裝
prevent=防止
pride=驕傲
prison=監獄
prize=獎
professor=教授
pronunciation=發音
proper=適當
prove=證明
pupil=國小生
pure=純
quality=質量
quantity=數量
quarrel=爭吵
race=比賽
rapid=迅速
ray=射線
reach=達到
recent=新近
reduce=降低
refer=呈交
regard=看
regular=有規律
relation=關係
remain=剩下
remove=除去
reply=回答
report=報告
republic=共和國
request=請求
require=要求
research=研究
result=結果
return=返回
revolution=革命
ripe=成熟
rock=岩石
rode=乘
role=角色
roll=滾
root=根
rough=粗糙
row=排
rubbish=垃圾
Russian=俄語
said=說
sang=唱歌
sank=下沉
sat=坐
satisfaction=滿意
saw=看見
scene=發生地點
scientific=科學
scold=訓斥
scream=尖聲喊叫
seed=種子
seek=尋找
seize=抓住
self=自我
sense=感覺
sent=送
separate=分開
set=確定
settle=解決
sew=縫紉
sex=性
shade=蔭涼
shadow=陰影
shame=羞恥
sharp=敏銳
shock=震動
shone=發亮
shook=搖晃
shoot=射擊
shot=射擊
sight=情景
silk=絲綢
simply=簡單
situation=情勢
slave=奴隸
smooth=光滑
soft=柔軟
soil=土壤
sold=出售
solder=焊接
solid=固體
sort=種
sought=尋找
soul=靈魂
southern=南方
Spanish=西班牙語
spare=節省
spat=吐痰
speed=速度
splendid=壯觀
spoke=講話
sprang=跳起
spread=傳播
stage=階段
stair=樓梯
standard=標準
stare=凝視
state=州
steel=鋼
step=走
stick=棍
stole=偷
stone=石頭
stood=站
strength=力量
strict=嚴格
struck=罷工
struggle=奮鬥
subject=主題
suffer=遭受
surface=表面
swam=游泳
swept=掃
tailor=裁縫
tale=故事
tap=利用
task=任務
taught=教
technical=技術
technique=技術
telegram=電報
terribly=十分
text=正文
theatre=劇院
therefore=因此
thread=線
threw=投
throughout=全部
thus=因此
tight=緊
tin=罐
tip=建議
tire=胎環
tobacco=煙草
told=告訴
ton=公頓
took=帶
top=熱門
total=總
tour=旅行
tourist=遊客
towards=對於
track=蹤跡
translate=翻譯
trick=計謀
twice=兩次
underground=在地下
unit=單位
unite=結合
university=大學
unless=除非
upward=向上
used=使用
variety=綜藝
various=各種各樣
vast=巨大
warn=警告
wealth=財富
weigh=重量為
well-known=著名
whatever=無論如何
wheat=小麥
whenever=無論何時
wherever=無論那裡
whilst=當時
whisper=低聲地說
willing=願意
wine=酒
wipe=擦
wire=電線
within=在內
won=贏
wonder=想知道
wore=穿
worse=壞
worth=值
suggest=建議
support=支援
suppose=假定
socialism=社會主義
socialist=社會主義
sock=短襪
abdomen=腹部
abide=忍受
abnormal=異常
abolish=廢除
abrupt=突然
absence=不在
absentminded=心不在焉
absolute=絕對
absorb=吸收
absorption=吸收
abstract=摘要
absurd=荒謬
abundant=豐富
abuse=虐待
academic=學術性
academy=高等學校
accord=協議
according=依照
accordingly=因此
account=賬
accountant=會計師
accounting=說明
acute=厲害
ad=廣告
adapt=使適應
add=增加
adhere=黏著
adjacent=臨近
administrate=管理
administrator=管理者
admiration=讚賞
admire=欣賞
admission=承認
adolescent=青年期
adoption=採用
advantage=優勢
advantageous=有利
adventure=冒險
aggressive=積極
agony=苦惱
agreeable=令人愉快
agreement=協議
agricultural=農業
alcohol=酒精
alert=警惕
alien=外國人
allege=聲稱
alleviate=減輕
alliance=聯盟
allied=聯合
allocate=分發
allowance=津貼
alloy=合金
ally=聯合
alongside=在旁邊
aloud=高聲
altar=祭壇
alter=改變
alteration=改變
alternate=交替
altitude=高度
aluminum=鋁
amateur=業餘者
ambiguous=含糊
amend=改正
ampere=安培
ample=充裕
amplifier=放大器
amplify=放大
amusement=娛樂
analog=類比
analogy=類似
analytic=分析
angel=天使
announce=宣佈
announcer=廣播員
annoy=惹惱
annual=每年
anonymous=匿名
Antarctic=南極洲
antibody=抗體
anticipate=預期
anticipation=預期
antique=古老
anxiety=憂慮
anxious=焦慮不安
anyhow=無論如何
apart=分開
apologize=道歉
apology=道歉
apparent=明顯
appeal=請求
appearance=外表
appetite=胃口
apt=容易
arch=拱
architect=建築師
arctic=北極
argument=辯論
arise=出現
arithmetic=算術
army=軍隊
arouse=引起
array=陣列
arrest=逮捕
arrival=到達
arrow=箭
article=文章
articulate=發音清楚
artificial=人造
ascend=上升
ascertain=探查
ashore=向岸上
Asian=亞洲人
aside=到一旁
aspect=方面
assault=突擊
assemble=集合
assembly=會議
assert=認定
assess=評價
asset=資產
attempt=試圖做
attend=參加
attendant=服務生
attention=注意
attentive=注意
attitude=態度
attract=吸引
attraction=吸引力
attractive=有吸引力
attribute=把歸於
augment=增大
aural=耳
automatic=自動
automation=自動化
avail=有用
avert=避開
aviation=航空
bachelor=單身漢
badge=徽章
badly=不好
balance=平衡
bald=單調
balloon=氣球
ban=禁止
bandage=繃帶
bang=砰地一聲
bankrupt=破產
bankruptcy=破產
banner=旗幟
bar=酒吧
bare=    裸露
barely=僅僅
bargain=契約
barn=穀倉
barrel=桶
barrier=障礙
bathe=洗
battery=電池
battle=戰鬥
bay=海灣
beam=梁
bearing=忍受
beast=野獸
beauty=美容
became=變得
beforehand=事先
beg=懇求
beggar=乞丐
beginner=初學人
behalf=利益
behavior=行為
bent=彎曲
betray=背叛
beware=注意
bewilder=使為難
beyond=在遠處
bias=偏見
bible=聖經>>
bibliography=書目
bid=投標
bile=膽汁
billion=十億
bind=捆
biography=傳記
biological=生物的
biology=生物學
birth=誕生
birthplace=出生地
biscuit=餅乾
bishop=主教
bit=一點兒
bitch=母狗
blade=葉片
blame=責備
blast=爆炸
blaze=火焰
bleak=荒涼
bless=祝福
blessing=祝福
bloke=小子;傢伙
blood=血
bloody=帶血
bloom=花
blossom=花
blunder=大錯
blunt=鈍
blush=臉紅
board=俱樂部
boiler=鍋爐
bonus=紅利
boost=推進
boot=靴子
booth=貨攤
border=邊境
borne=忍受
bough=大樹枝
bound=邊界
boundary=邊界
boycott=聯合抵制
brake=剎車
brand=品牌
brass=黃銅
bravery=英勇
breadth=寬度
breast=胸博
breath=氣息
breathe=呼吸
breed=造成
breeze=微風
brisk=興旺
brochure=小冊子
broke=毀壞
broken=毀壞
broker=經紀人
bronze=青銅
brook=忍耐
broom=掃帚
brought=帶來
brow=眉
brutal=野蠻
bubble=泡
budget=預算
bulb=燈泡
bunch=一群
burden=負擔
bureau=局
bury=埋
bush=灌木叢
butcher=屠夫
button=鈕扣
camel=駱駝
campaign=運動
canal=運河
candidate=候選人
cannon=大砲
canoe=獨木舟
canteen=食堂
canvas=帆布
capable=有能力
capacity=能力
capital=首都
capitalism=資本主義
capsule=膠囊
captive=被俘獲
carve=雕刻
casualty=傷亡
cathedral=大教堂
catholic=普遍
cattle=牛
caught=抓住
cause=引起
caution=警告
cautious=小心
cavalry=騎兵
cave=洞
cease=停止
cell=小屋
cellar=地窖
cement=水泥
census=人口普查
certify=證明
chain=鏈子
chairman=主席
challenge=挑戰
chamber=寢室
champion=冠軍
chaos=混亂
chap=使皸裂
cherish=珍愛
chestnut=栗子
chew=嚼
chief=首領
childhood=童年
chop=砍
chorus=合唱
Christ=基督
Christian=基督教徒
chronic=慢性
cigar=雪茄煙
cigarette=香煙
cinema=電影院
circuit=電路
circular=圓
circulate=循環
circumference=周長
circumstance=情形
circus=馬戲團
civilian=平民
civilization=文明
civilize=教化
claim=聲稱
clarify=驗証
clarity=明了
clash=衝突
clasp=扣
climax=高潮
cling=黏住
clip=夾子
clockwise=順時針
cloze=克漏字
clue=線索
clumsy=笨拙
cluster=群
clutch=抓
coal=煤
code=代碼
coherent=一致
coil=線圈
coincide=與同時發生
coincidence=巧合
collapse=瓦解
collar=衣領
colleague=同事
collide=相撞
colonel=上校
colonial=殖民地
committee=委員會
communicate=交流
communication=通訊
compact=緊密
compartment=分隔間
compatible=相容
compensate=補償
compensation=補償
competitive=具有競爭性
competitor=競爭者
compile=編輯
complaint=抱怨
complement=補足
complementary=補充
completion=完成
complex=複雜
complexity=複雜性
compliance=服從
compliment=  讚美
comply=答應
component=零件
comprehend=理解
compulsory=強製
compute=計算
concede=承認
concentrate=集中
concentration=集中
condition=狀態
conduct=處理
conference=會議
confess=承認
confession=承認
conquer=克服
conquest=征服
conscience=良心
conscious=有意識
consent=同意
contradict=反駁
contrive=發明
conventional=道統
conversion=變換
convert=轉變
convey=運送
cooperative=合作
cordial=誠懇
corrode=腐蝕
corrupt=腐敗
cosmic=宇宙
cottage=農舍
counterpart=極相似的物
countryside=農村
coward=懦夫
cradle=搖籃
cricket=板球比賽
cripple=跛子
crisp=脆
criterion=標準
criticism=批評
crossing=穿過
crow=烏鴉
cubic=立方
cucumber=黃瓜
cunning=狡猾
customary=通常
cylinder=汽缸
daring=勇敢
dart=飛奔
dazzle=使暈眩
deadly=致命
deafen=使不漏音
dealer=經銷商
deepen=加深
deeply=深深
deficiency=缺乏
deficient=缺乏
deficit=赤字
deform=使殘廢
defy=使不可能
denial=否定
denote=指示
depict=描繪
deposition=免職
detach=分開
detain=留住
deteriorate=惡化
development=發展
deviate=背離
devotion=獻身
dew=露
diagnose=診斷
dictator=獨裁者
differentiate=使有差異
diffuse=擴散
digit=數字
disgrace=恥辱
dishonor=恥辱
dismay=驚慌
dispatch=發送
displace=移動
displacement=替代
displease=使不高興
diversion=轉向
dock=碼頭
doctrine=教條
documentary=紀錄片
domain=領土
dome=圓屋頂
donate=捐贈
doom=毀滅
dove=潛水
doze=瞌睡
drastic=激烈
drawback=不利
dread=恐怖
dreadful=可怕
drought=乾旱
dubious=可疑
duplicate=複製
dynasty=王朝
earthenware=陶器
easily=容易
eclipse=日食
ecology=生態學
edible=食用
eject=噴射
eldest=最年長
electrician=電機師
electrify=使帶電
electronics=電子
elevation=升高
elite=精英
eloquent=雄辯
endurance=忍耐
engagement=約會
equator=赤道
erase=擦掉
erosion=腐蝕
erroneous=錯誤
erupt=爆發
essence=本質
establishment=建立
esthetic=感官
etc=等等
eternal=永久
everlasting=永久
exactly=正好
exceedingly=非常
exceptional=特別
excessive=過度
exemplify=例證
expedition=探險
expel=驅逐
expenditure=支出
expertise=專門技能
expire=終止
extravagant=奢侈
extremely=強烈
fable=寓言
fashionable=流行
feast=宴會
feeble=虛弱
fellowship=友誼
feminine=婦女
ferry=渡船
fierce=兇猛
finite=有限
fireplace=壁爐
firework=焰火
fishery=漁業
fixture=固定設備
flare=閃光
flatten=使變平
flaw=瑕疵
fling=猛投
fluctuate=波動
foam=泡沫
foodstuff=食品
forefather=祖先
forefinger=食指
foremost=最先的
foresee=預見
formulate=闡述
forthcoming=即將要來
forum=論壇
fossil=化石
fracture=裂縫
fragile=脆
fragrant=芳香
Frenchman=法國人
friction=磨擦
friendship=友誼
fro=往返
furious=猛烈
fuse=保險絲
galaxy=星系
gallop=飛跑
gamble=賭博
garment=服裝
gigantic=龐大
glare=耀眼
glide=滑動
gloomy=憂郁
glorify=讚美
gossip=閒談
graceful=優雅
gracious=親切
grease=油脂
grieve=使悲痛
groan=呻吟
grocery=雜貨店
gross=總
gunpowder=火藥
habitual=習慣
hail=雹
haircut=理髮
hamper=妨礙
handbook=手冊
handicap=障礙
handout=傳單
hare=野兔
harmful=有害
hasten=趕快
hasty=急速
hatch=孵
hateful=恨
haul=拖運
hawk=鷹
heartily=十分
heavily=重
heighten=增大
heir=繼承人
helmet=鋼盔
hillside=山腰
hind=在後
hinder=妨礙
hinge=絞鏈
historian=史學家
hitherto=至今
holder=持有者
homogeneous=同類
horizontal=水準
hysteric=  病
icy=冰冷
identification=鑑定
idiom=習語
ignite=點火
illiterate=文盲
impartial=公平
impetus=動力
implicit=暗示
importance=重要
improper=不恰當
impulse=脈波
inaccessible=不易接近
incidence=發生
incidentally=偶然
inclusive=包括
incorporate=合併
incur=招致
indoors=  市內
induce=引起
induction=就職
industrious=勤奮
industry=工業
inertia=慣性
infectious=傳染
infinity=無限
infrared=紅外
ingenious=機敏
inhabit=居住於
inherent=固有
initiate=起動
inject=注入
inland=內陸
inlet=進口
innovation=革新
innumerable=無數
inquiry=詢問
inspector=檢查員
instructor=教師
insulate=隔離
insulator=絕緣子
intact=完整
integral=不可缺少
integrity=完整
interact=相互作用
intercourse=交往
intermittent=間歇
interpreter=翻譯
intervene=調停
intricate=錯綜複雜
intuition=直覺
jargon=術語
jealousy=妒忌
jewelry=珠寶
jolly=快樂
junction=交叉口
kidnap=拐走
kidney=腎
kilowatt=千瓦
kindle=燃燒
knob=球形門柄
lace=花邊
lame=跛
landlady=女房東
lantern=燈籠
lark=雲雀
legend=傳奇
lengthen=變長
lessen=減少
lever=杠杆
liability=責任
lighten=減輕
lightly=  輕輕地
likelihood=可能
likeness=相象
limestone=石灰
linen=亞麻布
locomotive=機車運動的
longing=思慕
longitude=經度
loudspeaker=擴音器
lounge=休息室
lubricate=潤滑
lumber=木材
lunar=月
macroscopic=巨視
magnetism=磁性
magnify=放大
magnitude=大小
mailbox=信箱
manly=有男子氣概
manufacturer=製造商
manuscript=手稿
marble=大理石
marginal=邊緣
masterpiece=傑作
materialism=唯物主義
meadow=牧場
medical=醫學
melon=瓜
merchandise=商品
merciful=仁慈
miniature=微型畫
minimize=使減到最小
minister=部長
mischief=傷害
misery=痛苦
misfortune=不幸
mistress=主婦
moan=呻吟
mobilize=動員
mock=嘲笑
mortgage=抵押
moss=苔蘚
motorway=高速公路
mountainous=巨大
mourn=悲痛
mouthful=口
multiplication=乘
multitude=眾多
municipal=市政
murderer=兇手
murmur=喃喃聲
muscular=肌肉
musical=音樂
mute=默默
mutter=低聲說
mutton=羊肉
nap=小睡
narrate=講
nasty=骯髒
naught=無
necessitate=使成為必需
nickel=鎳
nickname=綽號
nominal=名義上
nominate=提名
novelty=新穎
numb=失去知覺
nutrition=營養
oak=櫟樹
oar=槳
oath=誓言
obedience=服從
obedient=服從
obscure=陰暗
obsolete=過時
occasional=偶然
odds=可能的機會
odor=氣味
offset=補償
offspring=子女
opaque=不透明
oppress=壓迫
optimize=優化
ore=礦石
ornament=裝飾
orphan=孤兒
orthodox=正統
overthrow=推翻
overtime=加班
overwhelm=壓倒
paddle=涉水
pamphlet=小冊子
pant=喘
pasture=牧場
patent=專利
patriotic=愛國
patron=贊助人
pearl=珍珠
pebble=卵石
peculiarity=特性
pedal=踏板
peel=剝
peep=偷看
pendulum=擺
penetration=洞察力
penicillin=青黴素
peninsula=半島
perfectly=完全
petty=小
photoelectric=光電
physically=身體上
physiology=生理學
pickup=加速
pictorial=照片
pint=品脫
pipeline=管道
pirate=海盜
pistol=手槍
piston=活塞
plague=瘟疫
poisonous=有毒
porcelain=瓷器
porch=門廊
porridge=麥片粥
prayer=禱告
preach=宣傳
precede=在前
prick=扎
printer=印表機
prisoner=囚犯
privacy=隱私
probability=可能性
proclaim=宣佈
proficiency=精通
profitable=賺錢
profound=深深
projector=投影機
prolong=延長
proof=證據
puff=一吹
punishment=處罰
puppet=木偶
purify=淨化
qualitative=性質上
quantitative=定量
quart=夸脫
quarterly=季度
quartz=石英
quench=    解渴
questionable=可疑
quiver=輕微的顫動
racket=球拍
radiate=散發出
radiator=暖氣裝置
radioactive=放射性
radioactivity=放射性
radium=鐳
rebellion=造反
recipe=烹飪法
reciprocal=相互
recite=背誦
reclaim=恢復
recollect=回憶
reconcile=使和解
rectify=糾正
reed=蘆葦
reel=捲起
refinery=精煉廠
refute=反駁
regenerative=更新
regime=政體
regularity=規律性
rehearsal=排練
reign=統治
relay=接替
reliability=可靠性
representation=代表
reptile=爬蟲
resemblance=類似
resent=  憎恨
resistance=抵抗
resistant=抵抗
respectable=可敬
respectful=有禮貌
rim=邊
rival=競爭者
robbery=搶劫
robe=長袍
rocket=火箭
romance=浪漫
rot=腐爛
rotary=旋轉
roundabout=迂迴
royalty=王室成員
ruby=紅寶石
ruthless=殘酷
sacred=神聖
safeguard=保護
salute=敬禮
satire=諷刺
scanty=缺乏
scent=氣味
scrap=廢料
seam=縫
seaman=海員
seaport=海港
seaside=海邊
sect=教派
sensation=感覺
sensor=傳感器
shaft=軸
shameful=可恥
shampoo=洗髮精
shear=剪
shepherd=牧羊人
shipment=裝船
silicon=矽
simulate=類比
skeleton=綱要
skyscraper=摩天大廈
slavery=奴隸制度
slipper=拖鞋
slit=切開
slogan=口號
slum=貧民窟
sly=隱祕
smog=煙霧
smuggle=走私
snatch=抓住
snobbish=勢利
sob=啜泣
sober=清醒
sociology=社會學
sparkle=閃耀
spear=用矛刺
speciality=專業
specimen=樣品
spectator=觀眾
splash=飛濺
sponge=海綿
sprinkle=撒
sprout=生長
squirrel=松鼠
stability=穩定
stainless=沒有污點
staircase=樓梯
startle=震驚
statesman=政治家
statistical=統計
stereo=立體聲
stern=嚴厲
steward=服務生
stool=凳子
acceptable=可接受
accessory=附件
accommodate=適應
accompany=伴隨
accordance=一致
accumulate=累積
accuracy=準確
accurate=準確
accusation=譴責
accuse=指責
accustom=習慣
acquaint=告知
acquaintance=熟識
acquire=獲得
acquisition=獲得
acre=土地
acrobat=雜技演員
activate=開動
actual=實際
advertise=做廣告
advertisement=廣告
advertising=廣告
advisable=明智
adviser=顧問
advocate=提倡
aerial=天線
aeroplane=飛機
aerospace=航空太空飛行
affair=事情
affection=愛
affiliate=使附屬於
affinity=密切關係
affirm=肯定
affirmative=肯定
Africa=非洲
agent=代理人
aggression=侵略
agitate=使焦慮
amaze=使驚奇
ambassador=大使
ambiguity=意義含糊
ambition=雄心
amid=在中
amount=數量
amp=安培
amuse=逗樂
amusing=有趣
analysis=分析
analyze=分析
ancestor=祖先
antenna=天線
apparatus=儀器
appendix=附錄
applaud=鼓掌
applause=掌聲
appliance=器具
applicable=適用
appoint=任命
appointment=約會
appraisal=評價
apprehension=理解
approach=接近
appropriate=合適
approval=贊成
approve=贊成
approximate=近似
approximately=大約
aquarium=水族館
architectural=建築
architecture=建築
archive=檔案
argue=辯論
assign=分發
assignment=任務
assimilate=吸收
assist=幫助
assistance=幫助
associate=同事
association=協會
assumption=假定
assurance=保證
assure=保證
astonish=使驚訝
astronaut=太空人
astronomy=天文學
ate=吃
athlete=運動員
Atlantic=大西洋
atmosphere=空氣
atmospheric=大氣
atomic=原子
attach=附上
attain=取得
attendance=出席
audience=觀眾
Australian=澳洲人
Austrian=奧地利人
author=作者
avenue=大街
average=一般
await=等待
awaken=喚醒
award=授予
aware=意識到
awful=糟糕
awkward=尷尬
awoken=醒來
bacteria=細菌
baggage=行李
belief=信任
beloved=深愛
bend=彎曲
beneath=在下面
beneficial=有利
beneficiary=受益人
benefit=好處
better=更好
boast=自誇
bold=大膽
bolt=螺栓
bond=債券
bookshop=書局
bookstand=書攤
boom=繁榮
bracket=括起來
brandy=白蘭地酒
breakdown=故障
brewery=啤酒廠
bribe=賄賂
bride=新娘
bridegroom=新郎
brief=摘要
brilliant=光輝
brim=邊
British=英國人
capture=捕獲
carbon=碳
career=頭班
cargo=貨物
carpenter=木工
carriage=運費
carrier=搬運工
casual=偶然
catalog=目錄
category=目錄
ceramics=陶器製法
certainty=確信
certificate=證明書
chancellor=大臣
changeable=可變
chapter=章
characteristic=特性
charming=迷人
cheerful=快樂
chemist=化學家
chemistry=化學
cheque=支票
cherry=櫻桃
chest=胸
classic=  經典
classification=分類
classify=分類
client=客戶
cliff=懸崖
clinic=  診所
closure=結束
clothe=給穿衣
cloud=雲
collection=收集
collective=集體
collision=衝突
colonist=    殖民家
colony=殖民地
column=專欄
combat=與作鬥爭
combination=結合
commercial=商業
commission=委托
commit=承諾
commodity=商品
commonly=通常
commonplace=平常
commonsense=  常識
commonwealth=聯邦共和國
communism=共產主義
communist=共產主義者
community=社區
commute=變換
companion=同伴
comparable=可比較
comparative=比較
comparison=比較
competition=比賽
complicated=錯綜複雜
compose=組成
composition=組成
compound=化合物
comprehension=理解
comprehensive=綜合
conceal=隱藏
concept=概念
conception=概念
concern=關係到
concerning=關係到
concert=音樂會
concession=讓步
conclude=結束
conclusion=結論
concrete=具體
condemn=譴責
condense=凝結
conditional=有條件
conductivity=傳導性
confer=商議
confidence=信任
confidential=祕密
confine=限制
confirm=確認
conflict=衝突
conform=一致
confront=面對
confusing=干擾
confusion=混亂
congratulate=祝賀
congress=代表大會
conjunction=連接
connect=溝通
connection=連接
conscientious=有責任心
consciousness=意識
consensus=共識
consequence=結果
consequently=從而
consolidate=鞏固
conspicuous=顯眼
constituent=組成
constitute=形成
construction=建設
contain=包含
contend=鬥爭
content=內容
continent=大陸
corner=角落
decided=決定
decimal=十進
decisive=決定性
decompose=分解
dedicate=奉獻
deduce=推斷
deem=認為
deprive=剝奪
descendant=後裔
designate=指定
desolate=孤獨
despise=輕視
destiny=命運
destruction=損壞
destructive=有破壞性
dignity=尊嚴
dilemma=兩難
directory=目錄
disable=傷殘
disastrous=災難性
discern=認出
disclose=透露
discovery=發現
discriminate=區別
disregard=罔顧
dissatisfy=不滿
distil=蒸餾
distillation=蒸餾
distinction=區別
distort=使變形
distract=轉移
disturbance=騷動
embark=乘船
embody=體現
emigrate=移民
empirical=經驗
encyclopedia=百科全書
endanger=危害
endeavor=努力
enlighten=啟發
enrich=豐富
enroll=登記
entertainment=娛樂
enthusiastic=熱心
epidemic=流行病
epoch=時代
explicit=明確
extinct=絕種
extinguish=熄滅
extract=選出
extraction=抽出
fabricate=建立
facilitate=簡化
Fahrenheit=華氏溫度表
fascinate=使著迷
gaseous=氣體
gasp=喘氣
gathering=收集
generalize=一般化
gently=溫柔
geology=地質學
hemisphere=半球
henceforth=從今以後
heritage=遺產
heroine=女英雄
hesitation=躊躇
hierarchy=階層
highland=高地
hijack=劫持
horn=角
hospitality=殷勤款待
hostage=人質
hostess=女主人
hug=緊抱
humanity=人類
hypothesis=假說
illustration=插圖
imaginative=富於想像力
imitation=模仿
immerse=使浸入
immune=免疫
impair=削弱
independence=獨立
indication=指示
indicative=指示
indignant=憤怒
indignation=義憤
inspiration=啟發
instability=不穩定
install=安裝
instantaneous=即時
instantly=立刻
institute=研究機構
instruct=通知
invalid=無效
invaluable=無價
invert=倒置
irregular=不規則
irregularity=不整齊
irritate=激怒
isotope=同位素
latent=潛在
lateral=橫向
latitude=緯度
leaflet=傳單
leakage=滲漏
liner=郵船
linger=持續
literally=照原文
lively=活潑
mainly=主要
malfunction=故障
maltreat=虐待
manifest=明白
manipulate=操作
messenger=即時通
microbe=微生物
microcomputer=微型電子計算機
microprocessor=微處理器
microscopic=微小
migrate=遷移
milky=乳
modesty=謙虛
modification=修改
momentary=瞬間
monetary=貨幣
monopoly=壟斷
monotonous=單調
monstrous=怪異
nonetheless=不過
northward=向北
notable=值得注意
noteworthy=值得注意
notorious=臭名昭彰
notwithstanding=儘管如此
nourish=養育
outbreak=爆發
outermost=最外
outfit=裝配
overflow=溢出
overhear=偷聽
overlap=重疊
parachute=降落傘
paradise=天國
paralyze=使麻痺
parameter=參數
parasite=寄生動物
parliament=議會
partial=部分
participant=參加者
pastime=消遣
perfume=香水
periodical=週期
perish=死亡
perpetual=永久
perplex=迷惑
persecute=迫害
pest=害蟲
petition=請願
plaster=熟石膏
plateau=高原
plausible=似是而非
plead=懇求
pneumonia=肺炎
poise=平衡
predominant=顯著
premier=首要
prescription=指示
preside=主持
presume=認為
prey=被捕食的動物
propeller=螺旋槳
property=財產
proportion=比例
proposition=建議
propulsion=推進力
prosper=繁榮
proton=質子
radius=半徑
rake=耙
rapidity=迅速
rarely=很少
razor=剃刀
realization=實現
reap=收割
relic=遺物
remainder=剩餘
remarkable=驚人
renovate=革新
repay=報答
replacement=替換
restriction=限制
resultant=因而發生
revenge=報復
revolve=旋轉
riddle=謎
scholarship=獎學金
shipwreck=海難
shortcut=快捷模式
shorthand=速記
shriek=尖叫聲
shutter=百葉窗
sideways=斜著
signify=表示
solidify=凝固
soluble=可溶
sorrowful=悲哀
southward=向南
soviet=蘇維埃
spontaneous=自然
stationary=穩定
stationery=文具
