abide=v.忍受,等候
abolish=v.廢除,廢止
abortion=n.墮胎
abrupt=adj.突然的,意外的
absurd=adj.荒謬的,愚蠢的
abundant=adj.大量的,充足的, 豐富的
academy=n.學院,大學,研究院
accustom=v.使習慣於
ace=adj.第一流的,突出的;n.(紙牌)A,么點牌,專家,發球得分
acknowledge=v.承認
acknowledgement=n.承認,確認,致謝,回音,公證狀
acne=n.粉刺
admiral=n.艦隊司令, 海軍上將
adolescence=n.青春期
adolescent=adj.青少年的,未成熟的;n.青少年
adore=v.崇拜,愛慕
adulthood=n.成年(期)
advertiser=n.刊登廣告者,廣告客戶
affection=n.愛慕,鍾愛
agenda=n.議程
agony=n.極度痛苦
agricultural=adj.農業的
AI=n.人工智慧 (artificial intelligence)
airtight=adj.密閉的,無懈可擊的
airway=n.風道,氣道,航空公司
aisle=n.通道,走道
algebra=n.代數
alien=adj.外國的,外國人的;n.外國人,外星人
allergic=adj.過敏的
allergy=n.過敏症
alligator=n.短吻鱷
ally=v.使結盟,使聯姻;n.同盟國,同盟者
alter=v.改變,修改
alternate=adj.輪流的;v.輪流;n.代替者,候補者
altitude=n.高度,海拔
ample=adj.大量的,充裕的
anchor=v.拋錨,繫住,主持電視新聞節目;n.錨,靠山,電視新聞節目主持人
anthem=n.國歌,頌歌
antique=adj.年代久遠的,古董的;n.古物,古董,古風
applaud=v.向...鼓掌,稱讚
applause=n.鼓掌歡迎,喝采
apt=adj.易於...的,恰當的,聰明的
architect=n.建築師
architecture=n.建築學
arena=n.體育場,競技場
armor=v.穿盔甲(或加裝甲),提供防禦;n.盔甲,裝甲,(動、植物)保護層
ascend=v.登高,上升,
ass=n.驢子,笨蛋,太自負的人
assault=v.攻擊,抨擊,施暴;n.暴行,攻擊,抨擊,施暴
asset=n.財產,資產
astonish=v.使吃驚,使驚訝
astonishment=n.驚訝,驚愕
astray=adj.迷路的,離開正道的;adv.迷路,離開正道
astronaut=n.太空人,宇航員
astronomer=n.天文學家
astronomy=n.天文學
attendance=n.出席,出席人數,侍候
auditorium=n.會堂,禮堂
auxiliary=n.輔助者,助動詞
awe=v.使敬畏,使畏怯;n.敬畏,畏怯
awhile=adv.片刻
bachelor=n.單身漢
backbone=n.脊柱,支柱,骨幹
badge=n.徽章,證章
ballot=v.投票,投票表決;n.選票,候選人名單
ban=v.禁止,取締;n.禁止,禁令
bandit=n.強盜,土匪
banner=n.旗幟,橫幅,大標題
banquet=v.宴請;n.盛宴
barbarian=adj.野蠻(人)的;n.野蠻人
barbershop=n.理髮店
barefoot=adj.赤腳的;adv.赤著腳地
barren=adj.貧瘠的,荒蕪的,不妊的
bass=adj.低沈的,男低音的;n.男低音,低音樂器,鱸魚
batch=n.一批,一群,一爐,一團
batter=v.連續猛擊,搗毀,把...用舊;n.打擊手,糊狀物
bazaar=n.(中東的)市場,商店街,義賣
beautify=v.使更加美麗,美化
beforehand=adv.事先,提前地
behalf=n.代表
belongings=n.財產,攜帶物品
beloved=adj.心愛的;n.心愛的人
beneficial=adj.有益的,有利的
beware=v.當心,提防
bid=v.吩咐,(拍賣中)喊價;n.出價
blacksmith=n.鐵匠
blast=v.炸開,吹奏,嚴厲批評;n.(一陣)疾風,突然吹奏,爆破
blaze=v.燃燒,閃耀,炫示;n.火焰,火災,光輝,掃射
bleach=v.漂白,曬得褪色,使脫色;n.漂白,漂白劑
blizzard=n.大風雪
blond=adj.白膚金髮碧眼的;n.白膚金髮碧眼的人
blonde=adj.白膚金髮碧眼的;n.白膚金髮碧眼的女人
blot=v.污損(名譽),(用吸墨紙)吸乾;n.墨水漬,污漬,污點
blues=n.藍調,憂鬱
blur=v.使模糊不清,使朦朧;n.模糊,模糊不清的事物
bodily=adj.肉體的,身體的,有形的;adv.親身地,以肉體形式,整體地
bodyguard=n.保鏢,護衛隊
bog=v.陷入泥沼,動彈不得;n.沼澤,泥塘
bolt=v.閂上,用螺栓拴緊,吞吃,衝出;n.門栓,螺栓,電光,衝撞
bonus=n.獎金,額外津貼,分紅
boom=v.發出隆隆聲,激增,暴漲,興旺;n.隆隆聲,景氣,激增,暴漲
booth=n.(有篷的)貨攤,崗亭,(餐廳等)雅座
boredom=n.無聊,厭倦
bosom=n.胸,乳房,(衣服的)襟,胸懷
botany=n.植物學,(總稱)一個地區的植物
boulevard=n.林蔭大道,大馬路
bound=v.與...接界,跳躍,彈回;n.跳躍,領域,界限
boundary=n.邊界,分界線,界限
bowel=n.腸,內部,深處
boxer=n.拳擊手,拳師,拳師狗
boxing=n.拳擊,拳術,裝箱
boyhood=n.(男姓的)童年
brace=v.支撐,做好準備;n.支柱,大括號,(牙齒)矯正器
braid=v.編成辮子,編成穗帶,編結;n.髮辮,穗帶
breadth=n.寬度,幅度,寬宏
bribe=v.向...行賄;n.賄賂
briefcase=n.公事包
broaden=v.變寬,變闊,擴大
bronze=adj.青銅製的,青銅色的;n.青銅,青銅製品,古銅色
brooch=n.女用胸針(或領針)
brood=v.孵蛋,籠罩,沈思,沮喪;n.一窩孵出的雛鳥,一家的孩子們
broth=n.(用肉、蔬菜等煮成的)湯
brotherhood=n.兄弟關係,同志關係
browse=v.瀏覽;n.瀏覽
bruise=v.使受瘀傷,碰傷(水果),挫傷(感情);n.青腫,(水果等)碰傷,挫傷
bulge=v.膨脹,凸起,裝滿;n.腫脹,凸塊,增長
bulk=n.體積,容積,大塊,大多數
bully=v.脅迫,欺侮;n.恃強欺弱者,惡霸
bureau=n.事務處
butcher=v.屠宰(牲口);n.肉販
cactus=n.仙人掌
calf=n.小牛,(鯨、象等的)幼兒,小腿
calligraphy=n.書法,筆跡
canal=n.運河,河渠
cannon=v.開砲,砲轟;n.大砲,榴彈砲
carbon=n.碳,複寫紙
cardboard=n.硬紙板,卡紙板
carefree=adj.無憂無慮的,輕鬆愉快的
caretaker=n.照顧者,管理人
carnation=n.康乃馨,淡紅色
carnival=n.狂歡節,嘉年華會
carp=n.鯉魚
carton=n.紙盒,紙板箱
category=n.種類,類別
cathedral=n.大教堂
caution=v.警告,使小心;n.小心,謹慎,警告
cautious=adj.十分小心的,謹慎的
celebrity=n.名人,名流
celery=n.芹菜
cellar=v.把...藏入地窖(或酒窖);n.地下室,地窖,酒窖
cello=n.大提琴
cellphone=n.手機,大哥大
cell-phone=n.手機,大哥大
cellular phone=n.手機,大哥大
centigrade=adj.攝氏的
Centigrade=n.攝氏度
ceremony=n.儀式,典禮
certificate=v.發證書給,用證書批准;n.證明書,執照
chair=n.椅子
chairman=n.主席
chairperson=n.主席(沒有性別歧視的字眼)
chairwoman=n.女主席,女議長
chant=v.反覆地唱(或說),吟誦;n.詠唱,吟誦,單調的語調
chatter=v.喋喋不休,吱吱叫;n.嘮叨,饒舌,吱吱聲
checkbook=n.支票簿
check-in=n.辦理投宿(或登機)手續,報到
check-out=n.檢查,調查,付款退租,下班離開
checkup=n.檢查,體檢
chef=n.(餐館等的)主廚,大師傅
chemist=n.化學家
chestnut=adj.栗色的;n.栗子,栗樹,栗色
chili=n.紅番椒
chimpanzee=n.黑猩猩
choir=n.(教堂的)唱詩班,合唱團
chord=n.(樂器的)弦,心弦,弦桿,和音
chubby=adj.圓胖的
circuit=n.環道,一圈,巡迴路線,電路
cite=v.引用,舉出,表揚
civic=adj.城市的,市民的
clam=n.蛤,蚌,守口如瓶的人
clan=n.氏族,部落,家族
clasp=v.扣住,鉤住,緊抱,緊握;n.扣子,鉤子,夾子,緊握,緊抱
clause=n.(文件的)條款,子句
cling=v.黏著,依附,墨守
clockwise=adj.順時針方向的,右旋的;adv.順時針方向地,右旋地
clover=n.苜蓿
cluster=v.使成簇(或群),叢生;n.串,簇,群
clutch=v.抓住,攫取;n.爪子,手,掌握,攫取,離合器
coastline=n.海岸線
cocoon=v.緊緊包住,使(自己)孤立;n.繭
coil=v.捲,盤繞,捲成圈;n.(一)捲,(一)圈,(一)匝,線圈
colleague=n.同事,同僚
colonel=n.陸軍上校
colonial=adj.殖民地的,殖民的;n.殖民地居民
combat=v.戰鬥,搏鬥,反對;n.戰鬥,格鬥,反對
comedian=n.喜劇演員
comet=n.彗星
commentator=n.(電臺、電視臺等)時事評論者
commission=v.委任,委託;n.佣金
commodity=n.商品,日用品
commonplace=adj.平凡的,普通的;n.司空見慣的事,老生常談
communism=n.共產主義
communist=adj.共產主義的;n.共產主義者
commute=v.減刑,通勤
commuter=n.通勤者
compact=adj.緊密的,結實的,小型的;v.使緊密,壓緊,使簡潔;n.連鏡小粉盒,小型轎車
compass=v.圖謀,計劃,包圍,達到,理解;n.羅盤,指南針,圓規
compassion=n.憐憫,同情
compassionate=adj.有同情心的,慈悲的
compel=v.強迫,強求
compliment=v.讚美,恭維;n.恭維,問候,致意
compound=adj.合成的,複合的;v.使惡化,使混合,使合成,以複利計算, 妥協;n.混合物
comprehend=v.理解,領會,包含
comprehension=n.理解,理解力
compromise=v.妥協,危及,洩露(祕密等);n.妥協,危及,(原則等的)放棄
compute=v.計算,估算,推斷
computerize=v.使電腦化,用電腦處理
comrade=n.夥伴,同事,(共產黨的)同志
conceal=v.隱蔽,隱藏
conceive=v.構想出,設想,懷孕
condemn=v.責備,譴責,判刑
conduct=v.引導,帶領;n.行為,品行,舉動
confession=n.承認,供認,告解
confront=v.面臨,遭遇
consent=v.同意,贊成;n.同意,贊成
conserve=v.保存,保護,節省;n.糖漬食品,蜜餞,果醬
considerate=adj.體諒的
console=v.安慰,慰問;n.操縱臺
constitutional=adj.憲法的,生來的;n.保健散步,保健運動
contagious=adj.接觸傳染的,(感情等)感染性的
contaminate=v.弄髒,污染
contemplate=v.凝視,思忖,仔細考慮
contemporary=adj.當代的;n.同時代的人,同年齡的人,同時期的東西
contempt=n.輕視,(對法庭等的)藐視
contend=v.爭取,競爭,搏鬥,聲稱
continental=adj.洲的,大陸的
continuity=n.連續性,一貫性
convert=v.轉變,變換,改變信仰
convict=v.證明...有罪,判...有罪;n.(服刑的)囚犯
copyright=v.為(書籍等)取得版權;n.版權,著作權
coral=adj.珊瑚的,珊瑚色的;n.珊瑚
corporation=n.股份(有限)公司
correspondence=n.一致,相對應,通信,(總稱)信件
corridor=n.迴廊,通道
corrupt=adj.腐敗的,貪污的;v.使腐敗,使墮落,賄賂
counsel=v.忠告,提議;n.商議,忠告,法律顧問
counselor=n.顧問,(學生的)輔導員,律師
counterclockwise=adj.逆時針方向的;adv.逆時針方向地
coupon=n.回數票,減價優待券
courtyard=n.庭院,天井
cowardly=adj.膽小的,懦怯的
cozy=adj.舒適的,愜意的
cracker=n.(淡或鹹的)薄脆餅乾,鞭炮
crater=v.使成坑, 形成坑;n.火山口,巨大坑洞
creak=v.發出咯吱咯吱聲;n.咯吱咯吱聲
creek=n.小河,溪
crib=v.作弊,抄襲;n.嬰兒床
crocodile=n.鱷魚
crossing=n.交叉,交叉點,橫穿,雜交
crouch=v.蹲伏,彎腰;n.蹲伏(姿勢)
crunch=v.嘎吱作響地咬嚼(或踩、壓);n.嘎吱吱(咬嚼)聲音,關鍵時刻
crystal=adj.水晶的;n.水晶
cuisine=n.烹飪(法),菜餚
curb=v.控制,遏止,勒住;n.人行道旁的水泥(或石)邊,抑制
currency=n.通貨,貨幣
curriculum=n.學校的全部課程
curry=v.梳刷(馬等),鞣製,用咖喱燒;n.咖喱
customs=n.關稅,報關手續,海關出入境口
dart=v.投擲(標槍等),投射,狂奔;n.標槍,鏢,飛奔
dazzle=v.使眼花,使驚羨;n.耀眼的光,令人讚歎的東西
decay=v.腐朽,衰退;n.腐爛,蛀牙
deceive=v.欺騙,蒙蔽
declaration=n.宣佈,宣告,宣言,聲明
delegate=v.委派...為代表;n.代表,會議代表
delegation=n.授權,代表團
democrat=n.民主主義者
denial=n.否認,拒絕
descriptive=adj.描寫的,描述性的
despair=v.絕望,喪失信心;n.絕望
despise=v.鄙視
destination=n.目的地,終點
destiny=n.命運,天數
destructive=adj.破壞的,毀滅性的
detergent=n.洗潔劑,洗衣粉
devotion=n.奉獻
devour=v.狼吞虎嚥地吃,吞沒
dialect=n.方言
disbelief=n.不信,懷疑
discard=v.拋棄,摒棄,丟棄;n.拋棄,丟棄
disciple=n.信徒,門徒
discriminate=v.歧視,區分出
dispense=v.分配,執行,配(藥)
dispose=v.配置,處置
distinction=n.區別,殊勳,榮譽
distinctive=adj.有特色的,特殊的
distress=v.使悲痛,使苦惱;n.悲痛,苦惱
document=v.用文件證明;n.文件,證件
doorstep=n.門階
doorway=n.出入口,門口
dormitory=n.學生宿舍
dough=n.生麵糰,現款
downward=adj.向下的,下降的,日趨沒落的;adv.向下,日趨沒落地,(時間)往後推移地
downwards=adv.向下
drape=v.(用布等鬆軟地)覆蓋,垂掛;n.簾(尤指窗簾),幔
dreadful=adj.可怕的
dresser=n.衣櫃
dressing=n.打扮,佈置,裝飾,(拌沙拉等用的)調料
driveway=n.車道
duration=n.持續,持久
dusk=n.薄暮,黃昏
dwarf=v.使顯得矮小,阻礙生長;n.矮子,矮小的動(植)物
dwell=v.居住,存在於,思索
dwelling=n.住處,寓所
eclipse=v.蝕,遮蔽,使失色,投下陰影;n.蝕,被遮蔽,黯然失色
eel=n.鰻魚
ego=n.自我,自負
elaborate=adj.精心製作的,煞費苦心的,辛勤的;v.精心製作
elevate=v.提高,振奮,升職
embrace=v.擁抱,包含,抓住(機會等);n.擁抱
endeavor=v.努力,力圖;n.努力,盡力
enroll=v.把...記入名冊,登記
enrollment=n.登記,入會,入伍,登記人數
ensure=v.保證,擔保
enterprise=n.企業,公司
enthusiastic=adj.熱情的,熱烈的
entitle=v.給...權力(或資格)
equate=v.用符號表示某種關係,等同
erect=adj.豎起的;v.使豎立,使豎直
erupt=v.噴出,爆發
escort=v.護送,為...護航,陪同;n.護衛隊,護航隊,護送,護航
estate=n.地產
esteem=v.尊重,評價;n.尊重,評價
eternal=adj.永久的,永恆的
ethic=n.倫理標準
evergreen=adj.常綠的,常青的;n.常綠樹,萬年青
exaggeration=n.誇張
exceed=v.超過,勝過
excel=v.勝過,突出
exceptional=adj.例外的,異常的,特殊的
excess=adj.過量的,額外的;n.超越,過量
exclaim=v.呼喊,驚叫
exclude=v.拒絕接納,排除在外
execute=v.實施,執行,處死
executive=adj.執行的,行政部門的;n.執行者,業務主管
exile=v.流放,放逐;n.流放,流亡,被流放者
extension=n.伸長,擴大,延期
extensive=adj.廣大的,廣闊的
exterior=adj.外部的,外面的;n.外部,外表,外景
external=adj.外面的,外來的;n.外表,表面
extinct=adj.(火等)熄滅了的,絕種的
extraordinary=adj.異常的,特別的
eyelash=n.(一根)睫毛,(一根)眼毛
eyelid=n.眼皮,眼瞼
fabric=n.布料,織品
fad=n.一時的流行(或風尚)
Fahrenheit=n.華氏溫標
falter=v.踉蹌,搖晃,結巴地說話
fascinate=v.迷住,使神魂顛倒
fatigue=v.使疲勞;n.疲勞,勞累
federal=adj.聯邦(制)的
feeble=adj.虛弱的,軟弱的
feminine=adj.女性的,女孩氣的,陰性的;n.女性,陰性,陰性詞(或形式)
fertilizer=n.肥料
fiancé=n.未婚夫
fiancée=n.未婚妻
fiber=n.纖維
fiddle=v.拉提琴,胡來,騙取;n.小提琴,欺詐
filter=v.過濾,滲透;n.濾器
fin=n.鰭,鰭狀物
fishery=n.漁業
flake=v.使成薄片,像雪花般覆蓋;n.小薄片
flap=v.(上下或前後)拍動,(鳥)振(翅);n.薄片,(信封的)蓋口,拍動
flaw=v.使破裂,使有缺陷;n.缺點,瑕疵,裂隙
flick=v.疾飛,掠過;n.(鞭子的)輕打,(手指的)輕彈
flip=v.(為作出決定而)擲(硬幣),輕拋;n.輕彈,輕擊
flourish=v.茂盛,繁茂,興旺;n.揮舞,炫耀性的動作
fluency=n.流暢,流暢的說話(或寫作)
foe=n.敵人,反對者
foil=n.箔,花劍劍術
folklore=n.民間傳說
forgetful=adj.健忘的
format=v.編排或安排成某種形式;n.版式,形式
foul=adj.惡臭的,污濁的,惡劣的,犯規的;v.污染,玷污,犯規,塞住;adv.違反規則地,不正當地;n.(比賽中)犯規
fowl=n.禽,禽肉
fraction=n.小部分,片段,碎片
framework=n.架構,組織
frantic=adj.(因喜悅或憤怒等)發狂似的
freight=v.裝貨於,運輸(貨物);n.(船運的)貨物,運費
frontier=n.邊境,邊疆,新領域
fume=v.冒煙,薰,發怒;n.煙,氣,憤怒
fury=n.狂怒,狂暴,猛烈
fuse=v.把保險絲接入(電路),熔接,裝引信;n.保險絲,引信
fuss=v.忙亂,小題大作,爭辯;n.忙亂,小題大作,爭論
gallop=v.(馬等)疾馳,飛跑;n.(馬等的)疾馳,騎馬奔馳
garment=n.服裝,衣著
gasp=v.倒抽一口氣,喘氣;n.倒抽一口氣,喘氣
gathering=n.集會,聚集
gay=adj.同性戀的;n.同性戀者
gender=n.性別
geographical=adj.地理學的,地理的
geometry=n.幾何學
glacier=n.冰河
glare=v.怒目注視,眩目地照射;n.瞪眼,怒視,刺眼的強光
gleam=v.發微光,閃現;n.微光,閃光,一絲
glee=n.快樂,歡欣
glitter=v.閃爍,光彩奪目;n.閃光,光彩,(裝飾用)小發光物
gloom=v.變陰暗,感到沮喪;n.陰暗,暗處,沮喪的氣氛
gnaw=v.啃,嚙,折磨
gobble=v.狼吞虎嚥,(火雞)咯咯地叫
gorge=v.塞飽,狼吞虎嚥地吃;n.峽谷,暴食
gorgeous=adj.燦爛的,華麗的,極好的
gorilla=n.大猩猩
gospel=n.基督教教義,福音書
grant=v.同意,准予;n.獎學金,助學金
gravity=n.地心吸力
graze=v.吃草,放牧,擦傷
grease=v.塗油脂於,賄賂;n.油脂,賄賂
greed=n.貪心
grim=adj.無情的,嚴厲的,恐怖的
grip=v.握牢,(咬或夾)牢,掌握;n.緊握,(咬或夾)住,理解,掌握
groan=v.呻吟,抱怨;n.呻吟聲,抱怨(聲)
gross=adj.總的,粗略的,令人噁心的;v.獲得...總收入(或毛利);n.總額,總量
growl=v.(狗等)嗥叫,(人)咆哮;n.嗥叫(聲),咆哮
grumble=v.發牢騷,咕噥,發轟隆聲;n.牢騷,轟隆聲
guideline=n.指南,指導方針
gulp=v.狼吞虎嚥,大口地吸(氣),哽住;n.吞嚥,一(大)口,哽塞(聲)
gust=v.吹強風;n.一陣強風
gut=v.取出內臟,損毀(房屋等)的內部;n.腸子,內臟,勇氣
gypsy=n.吉普賽人,流浪者
hairdo=n.髮式,髮型, 做頭髮
hairstyle=n.髮型
handicap=v.妨礙,使不利;n.障礙,不利條件
handicraft=n.手工藝,手工藝品
hardy=adj.能吃苦耐勞的,(植物等)耐寒的
harness=v.上挽具,套(馬),駕馭;n.馬具,挽具,保險帶
haul=v.拖,拉,拖運;n.拖,拉,拖運,一次獲得的量
haunt=v.(鬼魂等)常出沒於,縈繞,常去;n.常去之處
hearty=adj.衷心的,健壯的,豐盛的
heavenly=adj.天堂般的
hedge=v.用樹籬圍住,兩面下注;n.樹籬,界限,兩面下注
heed=v.留心,注意;n.留心,注意
heighten=v.加高,增高,增加
heir=n.繼承人,嗣子
hence=adv.因此,由此
herald=v.宣佈,通報,預示...的來臨;n.報信者,使者,先驅
herb=n.草本植物,藥草
hermit=n.隱士
heroic=adj.英雄的,英勇的;n.(常用 heroics ) 英雄辭令,豪壯行為
heterosexual=adj.異性戀的;n.異性戀的人
hi-fi=n.高傳真的音響裝置
hijack=v.劫持;n.劫持事件
hiss=v.發出嘶嘶聲,發出噓聲;n.嘶嘶聲,噓聲
hoarse=adj.(嗓音)嘶啞的
hockey=n.曲棍球
homosexual=adj.同性戀的;n.同性戀者
honk=v.發雁鳴,按喇叭;n.雁鳴或汽車喇叭聲
hood=v.罩上兜帽(或風帽),加罩於;n.兜帽,風帽,罩,車蓋
hoof=n.蹄
horizontal=adj.水平的,橫的;n.水平線,水平面,水平位置
hostage=n.人質,抵押品
hostile=adj.敵方的,懷敵意的
hound=v.(用獵狗等)追獵,緊追;n.獵犬,卑劣的人
housing=n.房屋,住宅
hover=v.盤旋,徘徊;n.盤旋,徘徊
howl=v.嗥叫,怒吼,大哭,大笑;n.嗥叫,怒吼,大哭,大笑
hurl=v.猛力投擲,發射,厲聲叫罵;n.猛力投擲
hymn=v.唱聖歌,唱讚美詩;n.讚美詩,聖歌
idiot=n.白癡,笨蛋
immense=adj.巨大的,廣大的
imperial=adj.帝國的
impose=v.徵(稅),加(負擔等)於
impulse=n.衝動,推動力
incense=v.激怒,敬香;n.香
index=v.編索引;n.索引,標誌,指示符號
indifference=n.漠不關心,無關緊要
indifferent=adj.不感興趣的,中立的,無關緊要的
indignant=adj.憤怒的,憤慨的
indispensable=adj.必不可少的,必需的
induce=v.導致,誘導,歸納出
indulge=v.沈迷於,滿足(慾望等),縱容
infinite=adj.無限的
inherit=v.繼承(傳統,遺產等)
initiate=adj.新加入的;v.創始,初學,(通過儀式)接納新成員;n.初學者,新加入者
inland=adj.內地的,內陸的;adv.向內地,向內陸;n.內地,內陸
innumerable=adj.無數的
inquire=v.訊問,查問,調查
institute=v.創立,設立,開始;n.(專科性的)學校,大學,研究所
insure=v.投保,確保
intent=adj.專注的,熱切的,堅決要做的;n.意圖,目的
interference=n.干涉,干預,擾亂
interior=adj.內的,內部的;n.內部,內地
interpretation=n.解釋,闡明
interpreter=n.通譯員
intuition=n.直覺
inward=adj.裡面的,內部的,內心的,向內的;adv.向內,向中心
inwards=adv.向內
isle=n.小島
issue=v.發行,發佈;n.問題,爭論,發行(物)
ivy=n.常春藤
jack=v.用千斤頂托起;n.千斤頂,(紙牌中的)"J"牌,杰克,水手
jade=n.玉,玉製品,綠玉色
janitor=n.清潔工,管理員,看門人
jasmine=n.茉莉,淡黃色
jaywalk=v.不守交通規則橫穿馬路
jeer=v.嘲笑,嘲弄;n.嘲笑,奚落人的話
jingle=v.發出叮噹聲;n.(鈴、硬幣等金屬的)叮噹聲
jolly=adj.快活的,高興的;v.用好話勸(某人)做...,開玩笑;adv.非常,很;n.快活 (常用 jollies)
journalism=n.新聞業,新聞學
journalist=n.新聞工作者
jug=v.(用罐)煮,燉,監禁;n.水罐,甕,壺,監牢
jury=n.陪審團
justify=v.證明...是正當的,辯解
juvenile=adj.少年的,孩子氣的,幼年的;n.青少年,幼體,兒童讀物
kin=adj.有親屬關係的,同類的,類似的;n.家族,同類
kindle=v.點燃,煽動,照亮
knowledgeable=adj.博學的,有見識的
lad=n.男孩,小伙子
lame=adj.跛腳的,站不住腳的;v.使跛腳,使...變得無力
landlady=n.女房東
landlord=n.房東
laser=n.雷射
lash=n.鞭打,(風浪等的)猛烈打擊,斥責
latitude=n.緯度,
lawmaker=n.立法者
layer=v.把...堆積成層;n.層,階層,地層
league=v.使結盟,使聯合;n.同盟,聯盟
legislation=n.立法,法規
lessen=v.變小,變少,減輕
lest=conj.惟恐,免得,擔心
lieutenant=n.中尉(或少尉),助理官
lifelong=adj.終身的,一輩子的
likelihood=n.可能,可能性
lime=v.撒石灰於;n.石灰,酸橙
limp=v.跛行;n.跛行
linger=v.繼續逗留,持續,磨蹭
livestock=n.(總稱)家畜
lizard=n.蜥蜴
locomotive=adj.活動的,移動的,火車頭的;n.火車頭
locust=n.蝗蟲
lodge=v.租房間給...住,申訴,暫住,投宿;n.木屋,小旅舍,守衛室
lofty=adj.高聳的,極高的,高傲的
logo=n.商標
lonesome=adj.寂寞的,孤單的,荒涼的
longitude=n.經度
lottery=n.獎券,彩票,抽籤,運氣
lotus=n.蓮花
lumber=v.伐木,(英國)拖累;n.木材,木料
lump=v.弄成一團,歸併到一起;n.團,塊,腫塊,小方塊
magnify=v.放大,擴大,誇張
maiden=adj.未婚的,少女的,初次的;n.少女,處女
mainland=n.大陸
mainstream=n.(河的)主流,主要傾向
maintenance=n.維持,維修,保養
majestic=adj.雄偉的,威嚴的,崇高的
majesty=n.雄偉,壯麗,(帝王的)威嚴
mammal=n.哺乳動物
manifest=adj.顯然的,清楚的;v.表明,顯示
mansion=n.大廈,大樓
maple=n.槭樹,楓樹
marginal=adj.頁邊的,邊緣的,不重要的
marine=adj.海的,海生的,海軍陸戰隊的;n.船舶,海運業,海軍陸戰隊隊員
marshal=n.元帥,高級將官,典禮官
martial=adj.戰爭的,軍事的,尚武的
marvel=v.感到驚訝,感到好奇;n.令人驚奇的事物(或人物)
masculine=adj.男性的,男子氣概的;n.男性,陽性,陽性詞
mash=v.把...搗成糊狀,壓碎;n.糊狀物,混合飼料
massage=v.給...按摩(或推拿);n.按摩(術),推拿
massive=adj.厚實的,粗大的,大量的
masterpiece=n.傑作,名作
mayonnaise=n.蛋黃醬,美乃滋
meantime=adv.其間,同時;n.其時,其間
mechanics=n.力學,機械學,技術,技巧
mediate=v.調停解決,傳達
menace=v.威脅,恐嚇;n.恐嚇,具有危害性的人(或物)
mermaid=n.美人魚
midst=prep.在...之中;n.當中,中間
migrant=adj.移居(尤指移出國境)的,流浪的;n.移民,候鳥
mileage=n.總英里數,(每單位燃料的)行駛哩數
milestone=n.里程碑,劃時代的事件
mingle=v.使混合,使相混,交往
minimal=adj.最小的,極微的
mint=n.薄荷,薄荷糖,造幣廠
miser=n.吝嗇鬼,守財奴
mistress=n.女主人,主婦
moan=v.呻吟,嗚咽,悲歎;n.呻吟聲,嗚咽聲,悲歎
mock=adj.假的,假裝的,模擬的;v.嘲弄,(為取笑而)模仿;n.嘲弄,笑柄,仿製品,模擬考
mode=n.方式,型,模式
modernize=v.使現代化
modify=v.更改,修改
molecule=n.分子,微小顆粒
monarch=n.君主
monstrous=adj.怪異的,駭人聽聞的,巨大的
mortal=adj.會死的,凡人的,致命的,極度的;n.人,凡人
moss=v.以苔覆蓋,使長滿苔蘚;n.苔蘚,泥炭沼澤
motherhood=n.母性,(總稱)母親們
motive=n.動機,主旨
mound=v.築牆防衛,堆起, 積成堆;n.土墩,墳堆,小丘,投手的踏板
mount=v.登上,騎上,鑲嵌,發動(攻勢);n.騎,可乘騎的東西,底座,山丘
mourn=v.哀痛,哀悼
mower=n.割草機,收割機
mumble=v.含糊地說,咕噥;n.含糊的話,咕噥
muscular=adj.肌肉的,健壯的
muse=n.沈思,冥想
mustard=n.芥末,芥菜,芥末色
mutter=v.咕噥,抱怨;n.咕噥,抱怨
mutton=n.羊肉
myth=n.神話,虛構的人(或事物)
nag=v.使煩惱,糾纏不休,不斷嘮叨;n.好嘮叨的人
naive=adj.天真的,幼稚的,輕信的
nasty=adj.齷齪的,卑鄙的,難處理的
navigate=v.航行於,飛行於,操縱,導航
newscast=n.新聞廣播
nibble=v.一點點地咬(或吃);n.細咬,啃,少量
nickel=v.鍍鎳於;n.鎳,五分鎳幣
nightingale=n.夜鶯
nominate=v.提名,任命
nonetheless=adv.但是,仍然
nonviolent=adj.非暴力的
nostril=n.鼻孔
notable=adj.值得注意的,顯著的;n.名人,顯要人物
noticeable=adj.顯而易見的,顯著的
notify=v.通知,公佈
notion=n.概念,想法,打算
novice=n.新手,初學者
nowhere=adv.任何地方都不
nucleus=n.(原子)核,細胞核,核心
nude=adj.裸的,與生俱有的;n.裸體畫像,裸體
oar=n.槳,櫓,划手
oasis=n.(沙漠中)的綠洲
oath=n.誓言,宣誓
oatmeal=n.燕麥片,燕麥粥
oblong=adj.橢圓形的;n.橢圓形
observer=n.觀察員,奉行者
obstinate=adj.頑固的,頑強的
occurrence=n.發生,出現,事件
octopus=n.章魚
odds=n.機會,可能性,投注賠率,不和
odor=n.氣味
olive=adj.橄欖的,橄欖色的;n.橄欖,橄欖色
opponent=n.對手,敵手,反對者
optimism=n.樂觀,樂觀主義
orchard=n.果樹園,果樹林
organizer=n.組織者,萬用記事本
orient=v.使...朝東,定方位,使熟悉情況;n.亞洲國家(尤指東亞)
oriental=adj.(珍珠等)光輝奪目的,優質的;n.東方人,亞洲人
ornament=v.裝飾,美化;n.裝飾品,裝飾
orphanage=n.孤兒院,孤兒身分
ostrich=n.駝鳥,有駝鳥心理的人
ounce=n.盎司,英兩
outdo=v.勝過,超越
outgoing=adj.直率的,往外的,即將離職的,友善的
output=v.生產,使出,輸出;n.出產,生產,產量
outsider=n.外人,門外漢,局外人
outskirts=n.(複數)郊外,郊區
outward=adj.向外的,往外去的;adv.向外,出海,出港
outwards=adv.向外,出海,出港,顯而易見地
overall=adj.總的,全部的,全面的;adv.總的來說,大體上;n.工作褲,工作服,防護服
overdo=v.把...做得過分,使過於疲勞
overeat=v.吃得過飽
overflow=v.滿(或多)得溢出;n.溢出,過剩,泛濫
overhear=v.無意中聽到,偷聽
oversleep=v.睡過頭
overwhelm=v.壓倒,征服,使受不了
overwork=v.使工作過度,使過勞,過度使用;n.過於繁重的工作,過勞
oyster=n.牡蠣,沈默寡言的人
ozone=n.臭氧
pacific=adj.(大寫) 太平洋的, 愛好和平的, 溫和的,平靜的;n.(大寫) 太平洋
packet=n.小包(裹),小捆,小袋
paddle=v.用槳划(船);n.槳,(桌球的)球拍
pane=n.窗玻璃片,窗格,嵌板
paradox=n.自相矛盾的議論
parallel=adj.平行的,同方向的;v.與...平行,比得上;n.平行線,平行面
parlor=n.客廳,接待室
participant=n.關係者,參與者
particle=n.微粒,顆粒
partly=adv.部分地
passionate=adj.熱情的,激昂的
pastime=n.消遣,娛樂
pastry=n.酥皮點心
patch=v.補綴,修補,拼湊;n.補釘,補片,貼片
patent=adj.專利的;v.取得...的專利權;n.專利,專利權
patriot=n.愛國者
patrol=v.巡邏,巡查;n.巡邏,巡邏兵
patron=n.贊助者,主顧(尤指老顧客)
peacock=n.孔雀,愛炫耀的人
peasant=n.農夫
peck=v.琢,輕吻;n.啄,啄痕,輕吻
peddler=n.小販
peek=v.偷看,窺視;n.偷偷看,一瞥
peg=v.用木釘釘,用木夾夾;n.栓,樁,(曬衣用)衣夾,(木製)假腿
penetrate=v.穿過,透過,識破,滲透入
perceive=v.察覺,感知,意識到
perch=v.(鳥)飛落,棲息,(在較高處)暫歇;n.(鳥類的)棲息處
performer=n.演出者,演奏者,表演者
peril=v.使有危險,危及;n.(嚴重的)危險,危險的事物
perish=v.消滅,暴卒,枯萎
permissible=adj.可允許的
persist=v.堅持,固執
personnel=n.(總稱)人員,員工,人事部門
pessimism=n.悲觀,悲觀主義
pier=n.碼頭,防波堤
pilgrim=n.香客,朝聖者
pillar=n.柱子,棟樑
pimple=n.丘疹,面皰
pinch=v.擰,夾;n.擰,夾,(一)撮
piss=v.小便;n.小便
pistol=v.用手槍射擊;n.手槍
plague=n.瘟疫,天災,禍患
plantation=n.大農園,造林地
playwright=n.劇作家
plea=n.請求,懇求
plead=v.為(案件)辯護,懇求
pledge=v.保證給予,許諾,發誓;n.保證,誓言,抵押
plow=v.犁,耕,開(路),破(浪)前進;n.犁,除雪機
pluck=v.採,拔...的毛,扯;n.(一)拉,(一)扯
plunge=v.投入,將...插入,急降;n.跳入,衝進,猛跌
pocketbook=n.錢包,皮夾子,袖珍本
poetic=adj.詩的,韻文的
poke=v.戳,捅,撥弄;n.戳,捅,撥弄,慢性子的人
polar=adj.北極的,南極的,截然對立的
porch=n.門廊,入口處,走廊
potential=adj.潛在的,可能的;n.可能性,潛力,潛能
poultry=n.家禽
prairie=n.大草原
preach=v.佈道,說教
precaution=n.謹慎,預防措施
preference=n.偏愛,優先(權)
prehistoric=adj.史前的,舊式的
prevail=v.勝過,優勝,流行
preview=v.試演,試映;n.預習,預告片
prey=v.捕食,掠奪;n.被捕食的動物,犧牲者
priceless=adj.無價的,稀世之珍的
prick=v.刺(穿),扎(穿),使內心極度痛苦;n.刺,扎,刺傷,悔恨
prior=adj.在先的,在前的,居先的;adv.在前,居先;n.修道院院長或副院長
priority=n.在先,重點,優先權
procession=n.一(長)列,一(長)排,隊伍
profile=v.畫側面像,描出輪廓,寫傳略;n.側影,輪廓,人物簡介
prolong=v.延長,拉長,拖延
prop=v.支撐,維持,架,擱;n.支柱,支撐物,後盾,道具
prophet=n.先知
proportion=v.使成比例,使平衡,分攤;n.比例,比率
prospect=v.勘探,找礦;n.預期,前途,盼望的事物
province=n.省,州
prune=v.修剪,修整,修枝;n.梅乾,深紫紅色
publicize=v.宣傳,公佈,廣告
puff=v.一陣陣地吹,喘氣,用粉撲施粉;n.(一)吹,粉撲,(奶油)鬆餅
pulse=v.搏動,跳動,振動;n.脈搏,有節奏的跳動
purchase=v.買,購買;n.所購之物
pyramid=n.(常大寫)金字塔,三角錐
quack=v.(鴨)呱呱叫;n.鴨叫聲
qualify=v.使具有資格
quart=n.夸脫(= 品脫)
quest=n.追求,探索
quiver=v.顫抖,抖動(翅膀等);n.顫抖,抖動,箭袋內的箭
rack=v.把...放在架子上;n.掛物架,(行李)網架
radish=n.小蘿蔔
radius=n.半徑
ragged=adj.破爛的,不整潔的,參差不齊的
rail=n.欄杆,扶手,鐵軌
rally=v.召集,團結,重新振作;n.大集會,重整旗鼓
ranch=v.經營牧場(或農場);n.大牧場
rascal=n.無賴,淘氣鬼
ratio=n.比率,比例
rattle=v.使發出咯咯聲,使驚惶失措;n.咯咯聲,吵鬧聲
realm=n.王國,國土,領土
reap=v.收割,收穫
rear=adj.後面的,背後的;n.後部,後面
reckless=adj.不在乎的,魯莽的
reckon=v.認為,把...看作,覺得,測量
recommend=v.推薦,介紹
reef=n.礁,暗礁
reel=v.捲,繞;n.捲軸,捲筒,一捲
referee=v.為...擔任裁判,仲裁;n.裁判員,仲裁人
refuge=n.躲避,避難,避難所
refute=v.駁斥,反駁
reign=v.君臨,統治;n.統治,在位期間
rejoice=v.欣喜,慶祝
relic=n.遺物,遺風,遺跡
reminder=n.提醒者,提醒物,催函
repay=v.償還,報答
reproduce=v.繁殖,複製
reptile=adj.爬行動物(似)的;n.爬行動物,爬蟲類
republican=adj.共和政體的;n.共和主義者
resent=v.憤慨,怨恨
resentment=n.憤慨,怨恨
reside=v.居住,駐在
residence=n.住所,住宅
resident=adj.居住的,定居的,常駐的;n.居民,住院醫生
resort=v.訴諸,憑藉;n.休閒度假之處,名勝
restrain=v.抑制,約束
resume=v.重新開始,繼續,恢復;n.(個人)簡歷
retort=v.反駁,回嘴;n.回嘴,反駁
reverse=adj.顛倒的,相反的,反向的;v.翻轉,倒退,反向;n.相反,反面,反向
revive=v.復甦,恢復生機,使甦醒
revolt=v.反叛,起義,使反感;n.反叛,起義,反感
revolve=v.旋轉,自轉,以...為中心
rhino=n.犀牛
rhinoceros=n.犀牛
rib=v.裝肋於,嘲弄;n.肋骨,排骨
ridge=v.使成脊狀;n.屋脊,山脈,(狹長的)隆起部
ridiculous=adj.可笑的,荒謬的,滑稽的
rifle=v.洗劫,劫掠;n.步槍,來福槍
rigid=adj.堅硬的,嚴格的,死板的
rim=v.形成邊緣,顯出邊緣;n.(尤指圓形物的)邊緣
rip=v.撕,扯;n.裂口
ripple=v.起漣漪,(頭髮等)呈波狀;n.漣漪,細浪,波紋
rival=v.與...競爭,比得上;n.競爭者,對手,敵手
roam=v.漫步,漫遊,流浪;n.漫步,漫遊,流浪
robin=n.知更鳥
robust=adj.強健的,健全的,結實的
rod=n.棒,桿,竿
rubbish=n.垃圾,廢物
rugged=adj.高低不平的,粗糙的,粗線條的
rumble=v.(雷等)隆隆響,(車輛)轆轆行駛;n.隆隆聲,轆轆聲
rustle=v.(樹葉,紙等)沙沙作響,使沙沙作響;n.沙沙聲,窸窣聲
sacred=adj.神的,神聖的
saddle=v.給(馬背)裝鞍,使負擔;n.馬鞍,(自行車、摩托車的)車座
saint=v.使成為聖徒;n.聖徒,道德崇高的人
salmon=adj.鮭肉色的,淺澄色的;n.鮭魚,鮭肉,鮭肉色
salute=v.向...行禮,向...致敬;n.敬禮,致敬,致意
sandal=n.涼鞋,拖鞋
savage=adj.野性的,兇猛的,殘酷的;v.兇猛地攻擊,激烈抨擊;n.野蠻人
scan=v.細看,審視;n.掃描
scandal=n.醜聞,醜事
scar=v.結疤,留下傷痕;n.疤,(物品等的)損傷痕
scent=v.嗅,聞;n.氣味,香味,蹤跡
scheme=v.策劃,密謀;n.計劃,方案
scorn=v.輕蔑,藐視;n.輕蔑,嘲笑
scramble=v.攀爬,雜亂蔓延,爭奪;n.爬行,攀登,爭奪
scrap=v.將...作為廢物,將...拆毀;n.碎片,小塊,破爛
scrape=v.刮,擦,勉強過日子;n.刮,擦,擦傷,擦痕
scroll=v.使成卷形,用渦卷飾裝飾;n.卷軸,渦卷形裝飾
sculptor=n.雕刻家
secure=adj.安全的牢固的;v.把...弄牢,關緊
segment=v.分割,切成片;n.部分,部門,切片
sensation=n.感覺,知覺,轟動
sensitivity=n.敏感性,感受性
sentiment=n.感情,情緒,感傷
sergeant=n.中士,警官
series=n.連續,系列
sermon=n.佈道,說教
server=n.侍者,伺服器
setting=n.安裝,設定,鑲嵌,背景
shabby=adj.破爛的,破舊的,邋遢的
sharpen=v.削尖,磨快
shatter=v.粉碎,砸碎
sheriff=n.警長
shield=v.保護,庇護,掩蓋;n.盾,保護者,擋板
shiver=v.發抖,打顫;n.顫抖,寒顫
shortage=n.缺少,不足,匱乏
shortcoming=n.缺點,短處
shove=v.推,撞,亂塞;n.推,撞
shred=v.切成條狀,用碎紙機撕毀(文件);n.碎片,碎條,破布
shriek=v.尖叫,發出尖聲;n.尖叫聲
shrine=n.聖壇,神殿
shrub=n.矮樹,灌木
shudder=v.發抖,戰慄;n.發抖,戰慄
shutter=v.為...裝遮板(或快門等),關(店);n.關閉物,活動遮板,(相機的)快門
silkworm=n.蠶
simmer=v.煨,燉,(危機等)即將爆發;n.即將沸騰(或爆發)的狀態
skeleton=n.骨骼,骨瘦如柴的人(或動物),概略
skull=n.頭骨,骷髏畫
slam=v.猛地關上,砰地放下,打成滿貫;n.砰然聲,(撲克牌的)滿貫
slap=v.摑...耳光,侮辱;adv.砰地,猛然地;n.摑,侮辱
slaughter=v.屠宰,屠殺;n.屠宰,大屠殺
slay=v.殺死,殺害
sloppy=adj.懶散的,草率的
slump=v.(沈重地)倒下,(經濟)衰落;n.暴跌,不景氣,消沈
sly=adj.狡猾的
smash=v.粉碎,瓦解,殺球;n.粉碎,瓦解,(演出等的)成功
snarl=v.吠,咆哮,纏結;n.吠,咆哮,纏結
snatch=v.奪走,抓住;n.奪取,抓走
sneak=v.偷偷地走,溜;n.溜走,不告而別
sneaker=n.運動鞋
sniff=v.嗅,用力吸,抽鼻涕;n.嗅,聞,吸氣聲
snore=v.打鼾;n.打鼾,鼾聲
snort=v.噴鼻息,輕蔑(或憤怒)地哼;n.噴鼻息,噴氣聲
soak=v.浸泡,使濕透;n.浸泡,浸漬
sober=adj.清醒的,沒喝醉的,嚴肅的;v.使醒酒,使清醒,變得嚴肅
soften=v.使變柔軟,使變和藹
sole=adj.單獨的,唯一的;v.給(鞋等)裝底(或換底);n.腳底,鞋底,襪底,底部,比目魚
solemn=adj.嚴肅的,莊嚴的,鄭重的
solitary=adj.單獨的,唯一的,隱居的;n.獨居者,隱士
solo=v.單獨地, 單獨表演,單飛;adv.單獨地;n.獨奏(曲),獨唱(曲),單飛
sovereign=adj.最高統治者的,具有獨立主權的;n.君主,元首,主權國家
sow=v.播(種)
spacecraft=n.太空船,航天器
spaceship=n.太空船
specialist=n.專家,專科醫生
specimen=n.樣品,標本
spectacle=n.景象,奇觀,壯觀
spectator=n.旁觀者,目擊者
spine=n.脊柱,書脊,骨氣
splendor=n.光輝,壯觀,輝煌
sponge=v.(用海綿)揩拭,海綿般地吸收;n.海綿,海綿狀物
spotlight=v.聚光照明,使公眾注意;n.聚光燈,公眾注意的中心
sprint=v.奮力而跑,衝刺;n.全速疾跑,短距離賽跑
spur=v.用靴刺踢,鞭策,鼓勵;n.踢馬刺,激勵,(雞等的)距,骨刺
squash=v.把...壓扁(壓碎),鎮壓
squat=adj.蹲著的,矮胖的;v.蹲坐,蜷伏;n.蹲坐,蜷伏
stack=v.把...疊成堆,堆放;n.乾草堆,一疊,煙囪
stagger=v.搖搖晃晃,蹣跚而行;n.搖晃,蹣跚
stain=v.沾污,染污,染色;n.污點,色斑,染色劑
stake=v.把...押下打賭,拿...冒險;n.股本,賭金,危險
stall=v.把...關入畜舍,使拋錨,支吾,拖延;n.廄,攤位,(汽車的)拋錨
stanza=n.詩的一節
startle=v.使驚嚇,使驚奇
statesman=n.政治家
statistic=n.統計量,統計數值
statistical=adj.統計的,統計學的
steer=v.掌(船)舵,駕駛;n.指點,建議
stereotype=v.使成為陳規,把...澆鑄成鉛板;n.陳規,鉛版印刷
stern=adj.嚴厲的,堅定的
stew=v.(用文火)燉,使極度不安,悶熱冒汗;n.燉肉,燜菜,燉煮的食物
steward=n.男服務員,管家
stewardess=n.(客機、輪船)女服務員
stink=v.發惡臭,名聲臭;n.臭氣
stoop=v.屈身,彎腰駝背,屈尊;n.彎腰,駝背,屈尊
storage=n.貯藏,貯藏庫
stout=adj.矮胖的,結實的,牢固的
straighten=v.把...弄直,澄清
straightforward=adj.一直向前的,正直的,簡單易懂的
strain=v.拉緊,伸張,竭力,扭傷,過濾;n.拉緊,張力,壓力,扭傷,血緣
strait=n.海峽
strand=v.使擱淺,處於困境;n.股,縷,絞,線,繩,串
strap=v.用帶捆綁(或束住);n.帶子,皮帶
stray=adj.迷路的,流浪的,零星的;v.迷路,流浪,分心,入歧途;n.迷路者,流浪者,走失的家畜
streak=v.形成條紋,疾駛,閃現;n.條紋,斑紋,光線
stride=v.邁大步走,跨越;n.闊步,步姿
stripe=n.條紋,斑紋,線條
stroll=v.散步,溜達;n.散步,閒逛
structural=adj.建築上的,建築用的,結構上的
stumble=v.絆腳,絆倒,踉蹌;n.絆倒,失足
stump=v.砍去...的幹,作巡迴政治演說;n.殘幹,(鉛筆)頭,(煙)蒂
stun=v.使昏迷,使大吃一驚
sturdy=adj.結實的,健康的,堅固的
stutter=v.結結巴巴地說話;n.結巴,口吃
stylish=adj.時髦的,漂亮的
submit=v.提交,呈遞,使服從
substantial=adj.大量的,實在的
substitute=v.用...代替,代替;n.代替物,代用品
suitcase=n.小型旅行箱,手提箱
sulfur=n.硫(磺),硫磺色
summon=v.召喚
superficial=adj.外表的,粗略的,膚淺的
superstition=n.迷信
supervise=v.監督,管理,指導
supervisor=n.管理人,指導者
suppress=v.鎮壓,壓制,抑制
supreme=adj.最高的,至上的
surge=v.(海浪)洶湧,激增;n.大浪,波濤
suspend=v.使中止
sustain=v.支撐,承受
swamp=v.使陷入沼澤,淹沒,使陷入困境;n.沼澤,沼澤地,困境
swarm=v.成群地移動(或飛行),擠滿;n.(密集的)一大群
sympathize=v.同情,憐憫
tackle=v.著手對付(或處理),擒抱並摔倒
tan=adj.鞣革的,棕褐色的;v.曬成棕褐色,鞣(皮);n.棕褐色,曬成的棕褐膚色,鞣料
tangle=v.使糾結,使混亂;n.糾結,紛亂
tar=v.塗焦油於,玷污,污辱;n.柏油,瀝青, 水手
tart=n.水果餡餅,水果蛋糕
taunt=v.辱罵,嘲笑,奚落;n.辱罵,嘲笑,被嘲笑的人
tavern=n.小酒館,小客棧
teller=n.敘述者,(銀行)出納員
tempo=n.速度,拍子
tempt=v.引誘,誘惑
temptation=n.引誘,誘惑,誘惑物
tenant=v.租,租賃,居住於;n.房客
tentative=adj.試驗性的,暫時性的,猶豫的
terminal=adj.末端的,終點的;n.終端機,接頭
terrace=v.使成梯形地;n.大陽臺,露天階梯看臺,梯田
thigh=n.股,大腿
thorn=n.刺,棘,惱人的事或人
thrill=v.使興奮,使激動,使毛骨悚然,顫抖;n.興奮,顫抖,引起激動的事物
thriller=n.恐怖小說(或電影等)
throne=n.王座,神座,君權,帝王
throng=v.擠滿,湧入;n.人群,大群,群集
thrust=v.用力推,刺,插;n.猛推,刺,驅動力
tick=v.發滴答聲,責備;n.(鐘,錶等的)滴答聲,蝨
tile=v.鋪砌瓦(或瓷磚等);n.瓦,瓷磚,地磚,(麻將等的)牌
tilt=v.使傾斜,使翹起,偏向;n.傾斜,傾向
tin=v.把...裝罐;n.錫,罐頭
tiptoe=v.踮著腳;adv.踮著腳;n.腳趾尖
toad=n.蟾蜍,令人討厭的人
toil=v.苦幹,艱難地行進;n.辛苦,勞累,苦工
token=n.標誌,象徵,代價券,籌碼
torch=v.如火炬般地燃燒;n.火炬,火把
torment=v.使痛苦,折磨,煩擾;n.痛苦,苦惱,折磨
torrent=n.洪流,(話語的)連發,(感情的)狂潮
torture=v.拷打,拷問,折磨;n.拷打,酷刑,折磨
tournament=n.比賽,錦標賽
toxic=adj.毒(性)的,有毒的
trademark=n.商標
traitor=n.叛徒,賣國賊,背叛者
tramp=v.腳步沈重地行走,踐踏,流浪;n.沈重的腳步聲,流浪,流浪者,蕩婦
trample=v.踩,踐踏,蔑視;n.踐踏,蹂躪,踐踏聲
transparent=adj.透明的,一目了然的,易懂的
treasury=n.金庫,庫房,國庫,寶庫
treaty=n.條約,協定
trench=v.挖溝,挖戰壕;n.溝,溝渠,戰壕
tribute=n.進貢,敬意,尊崇
trifle=v.戲弄,輕視;n.瑣事,小玩意,乳脂鬆糕
trim=adj.整齊的,苗條的;v.修剪,修整,整理,削減;n.修剪,修整,鑲邊飾
triple=adj.三倍的,三重的;v.使成三倍,三倍於;n.三倍數,三倍量,三個一組,三壘打
trot=v.(馬等)小跑,(人)慢跑;n.(馬等的)小跑,(人的)慢跑
trout=n.鱒魚,鮭鱒魚
tuck=v.把...塞進,使有褶襉;n.(衣服等的)褶襉,打褶
tuition=n.學費
tuna=n.鮪魚
tyrant=n.暴君,專橫的人
umpire=v.仲裁,當裁判;n.仲裁人,(棒球等的)裁判員
undergraduate=n.大學生,大學肄業生
underline=v.劃線於...之下,強調;n.底線
underneath=adj.下面的,底層的;adv.在下面,在底下;prep.在...下面;n.下面,底部
understandable=adj.可理解的,能懂的
undoubtedly=adv.毫無疑問地,肯定地
update=v.使...合乎時代,更新;n.最新的(信息、報導等),更新
upright=adj.挺直的,直立的,正直的;adv.挺直地,垂直地,豎著;n.垂直,豎立,直立的東西
upward=adj.向上的,升高的;adv.向上,在上面,以上,超過
upwards=adv.向上地,朝上
utter=adj.徹底的,十足的,絕對的;v.發出(聲音等),說,講
vacancy=n.空,空白,空房,空缺
vacuum=v.吸塵;n.真空,空白,吸塵器
vague=adj.(形狀等)模糊不清的,曖昧的
vanity=n.自負,虛榮,梳妝臺
vapor=n.水汽
vegetation=n.植被,草木
veil=v.用帷幕分隔,掩飾,戴面紗;n.面紗,帷幕,託詞
vein=n.靜脈,(葉、翅、礦)脈,紋理
velvet=adj.天鵝絨製的,柔軟光滑的;n.天鵝絨,絲絨
venture=v.冒險,大膽行事;n.冒險,企業
verbal=adj.言辭上的,動詞的;n.準動詞
versus=prep.(常略作v.或vs.)與...相對
vertical=adj.垂直的,豎的;n.垂直線,垂直面
veto=v.否決,反對;n.否決,否決權
via=prep.經由,取道,憑藉
vibrate=v.顫動,振動,震動
videotape=v.將(節目)錄到帶子上;n.錄影帶,錄像帶
viewer=n.觀看者,觀眾
vigor=n.vigor
vigorous=adj.精力充沛的
villain=n.壞人,反派角色
vine=n.藤,藤蔓,葡萄樹
violinist=n.小提琴手
visa=n.簽證
vow=v.發誓要,鄭重宣告;n.誓言,誓約
wade=v.涉水而行,艱難地前進;n.跋涉,艱難的行走
wail=v.慟哭,(警笛等)尖嘯,哀訴;n.慟哭聲,哀訴
ward=v.避開,擋開;n.病房,牢房,行政區
ware=n.(特定種類的)陶器,貨物
warehouse=v.把...存入倉庫;n.倉庫,批發店
warrior=n.武士,戰士,勇士
wary=adj.小心翼翼的,謹防的
weary=adj.疲倦的,厭倦的;v.使疲倦,使厭煩
weird=adj.怪誕的
wharf=v.靠碼頭;n.碼頭,停泊處
wheelchair=n.輪椅
whereabouts=adv.在哪裡;n.行蹤,下落
whereas=conj.(常用在句首)反之,而
whine=v.發哀鳴聲,發牢騷;n.哀鳴聲,牢騷
whirl=v.旋轉,迴旋;n.旋轉,迴旋
whisk=v.撢,打(蛋等), 迅速移動;n.撢,迅速移動,攪拌器
whiskey=n.威士忌酒
whisky=n.威士忌酒
wholesale=adj.批發的;v.以批發方式;adv.以批發方式,全部地;n.批發
wholesome=adj.有益健康的,強健的
widespread=adj.分佈(或散佈)廣的
widow=v.使成寡婦(或鰥夫);n.寡婦
widower=n.鰥夫
wig=n.假髮
wilderness=n.荒野,荒漠
wildlife=n.野生生物
wither=v.枯萎,凋謝
woe=n.悲哀,災難
woodpecker=n.啄木鳥
workshop=n.作坊,研討會
worship=v.崇拜,拜神,做禮拜;n.崇拜,敬神,禮拜
worthwhile=adj.值得花費時間(或金錢)的
worthy=adj.值得的
wreath=n.花圈,花冠
wring=v.絞,擰,緊握;n.絞,擰,扭
yacht=v.駕快艇,乘遊艇;n.快艇,遊艇
yarn=v.講故事,長談;n.紗,紗線,冒險故事
yeast=n.酵母,酵母片
yield=v.出產,使屈服,讓路;n.產量,利潤
yoga=n.瑜珈
zinc=n.鋅
zip=v.以尖嘯聲行進,拉開拉鍊;n.(子彈的)尖嘯聲,拉鍊,零
zoom=v.發出嗡嗡聲,將畫面推近或拉遠;n.嗡嗡聲,變焦攝影
