local=adj.當地的,本地的;n.[C](usu.pl.)當地居民,本地人
nod=vt.(nodded | nodded | nodding)點頭
frown=vi.皺眉
throughout=prep.遍及,遍佈;從頭到尾,自始至終
gesture=n.[C]手勢,姿勢
vary=vi.(varied | varied | varying)不同
various=adj.各式各樣的
variety=n.sing.種種,各式各樣
positive=adj.同意的,表示贊同的;樂觀的,積極的
traveler=n.[C]旅客,旅行者
travel=vi.旅行;n.[U]旅行,旅遊
culture=n.[C]文化
cultural=adj.文化上的
express=vt.表達,顯露
expression=n.[C]表達,表示
expressive=adj.極富表情的,意味深長的
approval=n.[U]同意,贊成
approve=vi.贊成,同意
tilt=vt.傾斜
disagreement=n.[U]意見不合
disagree=vt.意見不合
threat=n.[C](usu.sing.)構成威脅的人或事物;威脅,恐嚇
threaten=vt.對…構成威脅
offer=vt.提供,提出;n.[C]提供
palm=n.[C]手心,手掌
insulting=adj.侮辱的
insult=vt.侮辱;n.[C]侮辱
criminal=n.[C]犯人,罪犯;adj.犯罪的,犯法的
punishment=n.[C]處罰,懲罰
punish=vt.處罰,懲罰
tradition=n.[C]傳統
traditional=adj.傳統的,慣例的
impolite=adj.不禮貌的,粗魯的
polite=adj.有禮貌的
outward=adv.朝外面地,向外地
rescue=n.[U]援救,營救;vt.援救,營救
negative=adj.否定的;adj.負面的
realize=vt.瞭解,發覺;實現
dessert=n.[U]甜點
even though=即使,雖然
grow out of something=產生於…,源自於…
from time to time=偶爾,有時
bring about something=導致…
bring something on ~=給…招來(壞事)
