bunch=n.sing.(fml.)大量,大批;n.[C]一束
doubt=vt.懷疑,不確定;n.[C]疑慮,懷疑
doubtful=adj.懷疑的,有疑慮的
meaningful=adj.有意義的;adj.意味深長的
extraordinary=adj.出眾的,非凡的
ordinary=adj.一般的,平常的
refugee=n.[C]難民
irregular=adj.不規律的,不定期的
regular=adj.規律的,定期的
slogan=n.[C]標語,口號
crisis=n.[C](pl.crises)危機,緊要關頭
model=n.[C]榜樣,典範;n.[C]模型
seek=vt.(sought | sought | seeking)尋找,尋求
convey=vt.傳達,表達(感情、想法等)
genuine=adj.真誠的,誠懇的;adj.真正的
feature=vt.以…為主要特色、重點;n.[C]特色,特徵
border=n.[C]國境,邊界;vt.與…接壤
shelter=n.[U]庇護,遮蔽;vt.遮蔽,掩護
chill=n.sing.寒氣,寒冷;vt.使冰冷
ingredient=n.[C](尤指烹調用的)材料,成分
deserve=vt.值得,應得
offer=vt.提供,給予;vt.主動提出;n.[C]提議
equipment=n.[U]設備,器材
equip=vt.(equipped | equipped | equipping)配備,裝備
local=adj.當地的,本地的;n.[C](usu.pl.)當地居民,本地人
gesture=n.[C]表示,姿態;n.[C]手勢,姿勢
overlook=vt.沒注意到,忽略;vt.不予理會
aid=n.[U]援助,救援物資;n.[U]幫助;vt.幫助
abandon=vt.捨棄,逃離;vt.拋棄,遺棄
thanks to ~=幸虧…,由於…
think through something=認真考慮某事物
cater to ~=滿足…,迎合…的需求
pass on something (to someone)=傳遞某物(給某人)
at home=輕鬆自在
