promise=vi.vt.承諾;n.[C]承諾
material=n.[C](活動所需的)材料
mention=vt.提到
structure=n.[C]結構體,建築物
capable=adj.有能力的,能夠…的
capability=n.[C]能力
collaborate=vi.合作
collaboration=n.[C,U]合作
architect=n.[C]建築師
architecture=n.[U]建築
graduate=n.[C]大學畢業生;vi.畢業
graduation=n.[U]畢業
construct=vt.建造
construction=n.[C]建築物;n.[U]建造
constructive=adj.有建設性的
slightly=adv.稍微
slight=adj.細微的
rank=vi.vt.排序為…
ranking=n.[C]排名
unique=adj.獨特的
innovative=adj.創新的
innovate=vi.創新
innovation=n.[C]新方法
adjust=vt.調整
adjustment=n.[C]調整
rely=vi.依賴,信任
reliable=adj.可信賴的
feedback=n.[U]回饋意見
element=n.[C]要素
elementary=adj.初級的,基礎的
stability=n.[U]穩定
stable=adj.穩定的,穩固的
route=n.[C]途徑,路線
explore=vt.探索
exploration=n.[U]探索,探究
trial and error=反覆試驗
in charge=控,負責
figure out=想出
roll up one’s sleeves=挽起袖子(表示開始行動)
get stuck in=幹勁十足地開始做
