identity=n.[U]認同;n.[U](abbr.ID)身分
vital=adj.極重要的,要緊的
survey=n.[C]調查;vt.調查…的意見
conduct=vt.執行,實施;n.[U](fml.)行為
prefer=vt.(preferred | preferred | preferring)偏好,更喜歡
preferable=adj.更合適的,更好的
preference=n.[U]偏好,偏愛
commercial=adj.商業的,商務的;n.[C]商業廣告
commerce=n.[U]商業,貿易
celebrity=n.[C]名人
endorsement=n.[C]宣傳,支持
endorse=vt.宣傳,支持
ambassador=n.[C]代言人,代表人物;n.[C]大使,外交使節
suitably=adv.適當地,妥當地
suitable=adj.適合的
refreshment=n.[U]恢復精力
refreshments=n.pl.點心,飲料
refresh=vt.使恢復精力
ironically=adv.諷刺地,反諷地
ironic=adj.諷刺的,有諷刺意味的
irony=n.[U]具有嘲諷意味的事
contribute=vi.促成,造成;vt.捐助,捐獻
contribution=n.[C]貢獻
establishment=n.[U]建立,成立
establish=vt.建立,設立
signal=vt.表明,表達;vi.示意,打信號;n.[C]信號
purchase=vt.(fml.)購買;n.[U](fml.)購買
enable=vt.使能夠
originality=n.[U]獨特性,創意
original=adj.最初的,原先的
origin=n.[C](usu.pl.)起源,來源
phenomenon=n.[C](pl.phenomena)現象
evident=adj.明顯的,明白的
evidence=n.[U]證據
tremendous=adj.極大的
version=n.[C]樣式,版本
garment=n.[C](fml.)衣服
exceed=vt.(fml.)超過,超出
logo=n.[C]商標,標誌
buy into something=(infml.)(of a plan, an idea, etc.)相信…
these days=(infml.)現今,如今
on the outside=表面上,由外表看來
go beyond something=超出…,超過…
as a matter of fact=實際上,其實
get at something=查明…,瞭解…
see the light=終於明白、領悟
