decoration=n.[C]裝飾(品)
decorate=vt.裝飾
plain=adj.普通的,樸素的;adj.淺顯的
commercial=adj.商業化的;adj.商業的;n.[C](電視、廣播裡的)廣告
aspect=n.[C]方面
match=n.[C]比賽;vt.vi.搭配,相配
compete=vi.競爭
competition=n.[U]競爭
competitive=adj.競爭激烈的
competitor=n.[C]競爭者
sponser=vt.贊助
sponsor=vt.贊助;n.[C]贊助者,贊助商
protective=adj.保護的
protect=vt.保護
protection=n.[U]保護
potential=n.[U]潛力;adj.潛在的
coach=vt.訓練,培訓;n.[C]教練
goods=n.pl.商品
helmet=n.[C]頭盔,安全帽
deliver=vt.遞送
delivery=n.[U,C]遞送
annual=adj.每年的
tradition=n.[C,U]傳統
traditional=adj.傳統的
cancer=n.[U,C]癌症
barely=adv.幾乎無法
bare=adj.赤裸的
light up=照亮
then and there=當下
look forward to=期待
pass away=過世
come around=到來
keep up=繼續下去
ever since=從那時起
