recipe=n.[C]食譜,烹飪法
friendship=n.[C][U]友情,友誼
friendly=adj.親切的,友善的
chef=n.[C]廚師,(飯店、餐廳的)主廚
satisfying=adj.令人滿意的
satisfy=vt.(satisfied | satisfied | satisfying)使滿意,使滿足
pour=vt.倒(水、茶等)
similar=adj.相似的,類似的
similarity=n.[C]相似處,類似點
mix=vt.使混合;n.sing.混合
compliment=n.[C]讚美,稱讚;vt.讚美,稱讚
support=n.[U]支持;vt.支持
trust=n.[U]信任,相信;vt.信任,相信
hug=n.[C]擁抱;vt.(hugged | hugged | hugging)擁抱
encouragement=n.[U]鼓勵
encourage=vt.鼓勵
properly=adv.正確地,適當地
proper=adj.正確的,適當的
poem=n.[C](一首)詩
poet=n.[C]詩人
effort=n.[C]試圖,嘗試;n.[U]努力
tasty=adj.好吃的,可口的
require=vt.需要
requirement=n.[C](usu.pl.)必需品
ingredient=n.[C](尤指烹調用的)成分,材料
fond=adj.愛好的,喜愛的
stove=n.[C]爐子
therefore=adv.因此,所以
worth=prep.值得的;n.[U]價值
that is (to say)=意即,也就是說
sit back=不採取行動,袖手旁觀
for instance=例如
run into something=遭遇(困難、麻煩等)
in addition (to ~)=除…之外(還)
leave something alone=別動、別碰某物
when it comes to (doing) something=說到、提及(做)某事
