awful=adj.糟糕的
stare=n.[C]盯著看;vi.盯著看
whisper=n.[C]耳語;vt.vi.小聲說話
rude=adj.無禮的
tease=vt.嘲弄,取笑
purposefully=adv.故意地,有目的地
purpose=n.[C]目的
purposeful=adj.堅決的,有目的的
scary=adj.可怕的
scare=vt.使人害怕
overhear=vt.無意中聽到
incident=n.[C]事件
cruel=adj.殘忍的
cruelty=n.[U]殘忍
pretend=vi.vt.假裝
genuinely=adv.真誠地,真正地
genuine=adj.真正的
apologize=vi.道歉
apology=n.[C,U]道歉
gradually=adv.逐漸地
gradual=adj.逐漸的
approach=vi.vt.接近;n.sing.接近
absolutely=adv.非常地,完全地
absolute=adj.明確的,無疑的
defend=vt.保護,防禦
defense=n.[U]防禦,辯護
bully=n.[C]霸凌者;vt.霸凌
ceremony=n.[C]典禮
fit in=融入(環境、團體等)
around the corne=即將到來
sick to one’s stomach=非常難過
make peace=和好
make fun of=嘲笑,揶揄
at least=至少
apart from=除了…之外
