pilgrimage=n.[C]朝聖之旅
pilgrim=n.[C]朝聖者,香客
unify=vt.使…成為一體,凝聚
exaggeration=n.[U,C]誇張,誇大
exaggerate=vi.誇張,誇大
undoubtedly=adv.無疑地
authorities=n.pl.當局,掌權者
authority=n.[U]權力
cast=vt.擲,拋;n.[C]擲,拋;n.[C](一齣戲劇或一部電影的)全體演員
exact=adj.精確的
fade=vi.逐漸消失
throng=n.[C]聚集的人群,一大群人
explosive=adj.震耳欲聾的
explode=vi.vt.爆炸,引爆
explosion=n.[C]爆炸,爆裂
pierce=vt.vi.(光線、聲音等)穿過;vt.扎,刺穿
emerge=vi.出現
blessing=n.sing.神的祝福
bless=vt.祝福
kneel=vi.跪
pavement=n.[U](鋪過的)路面
hospitality=n.[U]好客
hospitable=adj.好客的
enthusiastically=adv.熱情地
enthusiastic=adj.熱情的
enthusiasm=n.[U]熱情,熱忱
facilities=n.pl.設施
facility=n.[C]場所
accommodations=n.pl.住宿
accommodate=vt.容納
religious=adj.宗教的
religion=n.[C]宗教
humanity=n.[U]人道,仁慈
ritual=n.[C]宗教儀式
designate=vt.指定,認定
belief=n.usually pl.宗教信仰;n.[U]相信,信心
set out=出發
send off=送行
in the meantime=期間,同時
all manner of=各式各樣的
be looking to ~=試圖…
