diary=n.[C]日記
engaged=adj.已訂婚的
engagement=n.[C]訂婚
scream=vi.尖叫;n.[C]尖叫聲
immediately=adv.立刻,馬上
immediate=adj.立即的
familiar=adj.熟悉的,眾所皆知的
origin=n.[C](usu.pl.)起源,由來
original=adj.起初的,原先的
custom=n.[C]習俗,風俗
evil=adj.邪惡的;n.[U]邪惡,罪惡
attend=vt.出席,參加
ceremony=n.[C]典禮,儀式
superstition=n.[C]迷信
superstitious=adj.迷信的
belief=n.[C]看法,信念;n.[U]相信,信心
event=n.[C]事件
prevent=vt.預防,阻止
prevention=n.[U]預防,阻止
related=adj.相關的,有關的
relate=vt.使有關聯,把…聯繫起來
relation=n.[C]關係,關聯
regard=vt.認為,視為
regarding=prep.(fml.)關於
scientific=adj.科學的
scientist=n.[C]科學家
proof=n.[U]證據
prove=vt.(proved | proven | proving)證明,證實
actually=adv.事實上,實際上
actual=adj.實際的,確切的
tend=vi.傾向,往往會
tendency=n.[C]傾向
associate=vt.把…聯想在一起
association=n.[C]聯想,聯想物
sneeze=vi.打噴嚏
nowadays=adv.當今,現今
artificial=adj.人造的,人工的
predict=vt.預測,預言
pop the question=(infml.)求婚
result in something=導致…,造成…
in no way=一點也不
knock on wood=敲木頭(希望留住好運、避免厄運時說的話)
stick to something=維持…,堅持…
bless you=保佑你(對打噴嚏者所說的話)
base something on something=以…為根據,以…為基礎
take the place of ~=代替…,頂替…
