anticipate=vt.預料,預期
anticipation=n.預料,預期
radically=adv.徹底地,完全地
radical=adj.徹底的,根本的
discourteous=adj.粗魯的,失禮的
courteous=adj.有禮貌的,客氣的
courtesy=n.禮貌,禮節
foul=adj.下流的,粗魯的,難聞的,糟糕的
incense=vt.激怒,使大怒
assault=n.嚴詞批評,抨擊,傷害罪;vt.攻擊,襲擊
supervisor=n.主管,監督者
supervise=vt.監督,督導
supervision=n.監督,指導
subordinate=n.部署,下屬;adj.從屬的;vt.使從屬於,使屬於次要地位
deadline=n.截止日期,最後期限
taunt=vt.奚落,嘲諷
harass=vt.騷擾
harassment=n.騷擾
scold=vt.責罵,訓斥
passive=adj.被動的,消極的
discount=vt.不予理會,低估,打折,降價;n.打折,折扣
plague=vt.使受折磨,煎熬;n.瘟疫,傳染病
impose=vt.使強制接受,迫使,強制執行,硬性推行
uncover=vt.揭露,發現
disabled=adj.殘疾的,喪失能力的
disable=vt.使傷殘,使喪失能力
trauma=n.創傷
halt=vt.使停止;n.停止,暫停
diminish=vt.使減少,使減弱
reassess=vt.重新評估,再次考慮
assess=vt.評估,評定
assessment=n.評估,評價
wound=n.傷口;vt.使受傷
heal=vi.癒合,復原
thereby=adv.因此
utter=vt.說出,講
hurl=vt.大聲辱罵,大力丟,猛扔
