adventurous=adj.好冒險的
adventure=n.[C,U]冒險;探險
tribe=n.[C]部落
tribal=adj.部落的;部族的
span=vt.持續;貫穿;n.[C]一段持續的時間
multiple=adj.多種多樣的;多個的
multiply=vi.vt.成倍增加;迅速增加
prosperous=adj.繁榮的;富裕的
prosperity=n.[U]繁榮;興旺;成功
prosper=vi.繁榮;興旺
plentiful=adj.豐富的;大量的
plenty=pron.大量;眾多;n.[U]充裕;富裕
elaborate=adj.精巧的;精心製作的;vi.vt.詳盡闡述;詳盡描述
appeal=vi.請求;懇求;呼籲;n.[C]呼籲;請求;n.[U]吸引力;感染力
shallow=adj.淺的;adj.膚淺的
species=n.[C]物種
harmony=n.[U]融洽;和睦
harvest=n.[C,U]收穫;收成;vt.vi.收割(莊稼);捕獵(動物、魚)
guarantee=vt.保證;擔保;n.[C]保證;擔保
scores=n.pl.大量;很多
score=n.[C]得分;比分;vt.得分
guideline=n.[C]usually pl.指導方針;準則
private=adj.私有的;私用的
privacy=n.[U]隱密;私密
sample=vt.試吃;品嚐;vt.嘗試;體驗;n.[C]樣本;樣品
spoil=vt.破壞
consequence=n.[C]結果;後果
consequent=adj.隨之發生的;作為結果的
dive=vi.潛水
disturb=vt.干擾;打擾
disturbance=n.[U,C]打擾;干擾;引起混亂或騷動的事物
wisdom=n.[U]智慧;才智
inhabitant=n.[C](某地的)居民、棲息動物
inhabit=vt.居住在;棲息於
under someone's wing=在某人的庇護之下
spread one's wings=(1)拍動翅膀(2)展翅高飛;初試身手
come with=伴隨
to come=在未來
a fish out of water=在陌生環境不得其所的人
in the same boat=在同一艘船上;面臨同樣的困境
