wander=vi.遊蕩,徘徊
distressing=adj.令人煩惱的,令人痛苦的
distress=vt.使煩惱,使痛苦;n.[U]煩惱,痛苦
evidence=n.[U]證據
evident=adj.明顯的,明白的
speed=n.[C]速度;vi.(sped | sped | speeding)加速
log=vi.(logged | logged | logging)砍伐樹木;vt.紀錄,記載;n.[C]原木
figure=n.[C](usu.pl.)數字,數據;vt.計算
global=adj.全球的,全世界的
defense=n.[U]保護,防衛
defend=vt.保護,防衛
defensive=adj.防衛的,防禦的
generate=vt.產生,造成
oxygen=n.[U]氧,氧氣
atmosphere=n.sing.(the～)大氣,大氣層;n.[C]氣氛,氛圍
harmony=n.[U]和諧,協調
extinct=adj.絕種的,滅絕的
identify=vt.(identified | identified | identifying)發現,找到;vt.指認,確認
identification=n.[U]辨認,鑑定
agriculture=n.[U]農業
agricultural=adj.農業的
vital=adj.極重要的,要緊的
conservation=n.[U](對動植物、自然資源等的)保育;n.[U](對珍貴物資的)節約
resist=vt.抗拒,忍住
resistance=n.[U]抗拒
recover=vi.恢復,復原
recovery=n.[U]恢復,好轉;n.sing.(身體健康)恢復,痊癒
flood=n.[C]洪水;vi.淹水
anchor=vt.使固定;n.[C]船錨
excess=adj.多餘的,額外的;n.sing.過多,過量
excessive=adj.過多的,過度的
pose=vt.造成,引起
devise=vt.發明,設計
formula=n.(pl.formulas or formulae)[C]方案,方法
ban=vt.(banned | banned | banning)禁止;n.[C]禁止
flame=n.[C]火焰
reduce=vt.降低,減少
reduction=n.[C]降低,減少
go by=(時間)流逝
take its toll on …=對…造成傷害、損失
engage in something=參加某事,參與某事
speed up something=促進某事的發生,使某事物加速
cut down something=砍倒某物;削減某事物
go up=焚毀;上升,上揚
