colorful=adj.五彩繽紛的
attract=vt.吸引,引起興趣
attraction=n.[U]吸引力
apply=vt.使用,應用;vt.申請
application=n.[C]申請
effect=n.[C]影響,效果
effective=adj.有效的
indicate=vt.象徵,表示
indication=n.[C]象徵,表示
affect=vt.影響
appetite=n.[U]食慾
environment=n.[C]環境;n.[C]自然環境
environmental=adj.環境的
influence=vt.影響;n.[C]影響,影響力
influential=adj.有影響力的
decorate=vt.裝飾
decoration=n.[U]裝飾
natural=adj.天然的
therefore=adv.因此,所以
brain=n.[C]頭腦
associate=vt.把…聯想在一起
association=n.[C]聯想,聯想物
diet=n.[C]節食;n.[C]日常飲食
imagine=vt.想像
meaning=n.[C]意思,意義
describe=vt.描述,描寫
description=n.[C]描述,描寫
besides=adv.此外,而且;prep.除了…之外還有…
aware=adj.變化,多樣化
variety=n.[U]種種,各式各樣
as for ~=phr.至於
in/by comparison (with~)=phr.與…相比較
calm down(someone)=phr.使某人平靜,冷靜
what's more=phr.再者,而且
cheer up(someone)=phr.振奮某人,使某人高興起來
on the other hand=phr.另一方面
spice up something=phr.為某物添加趣味
