beneath=prep.在…下面
rough=adj.粗糙的;adj.粗略的,大概的
earnest=adj.真誠的,認真的
appreciation=n.[U]感激
appreciate=vt.感激
remarkable=adj.非凡的,了不起的
talent=n.[C]天賦,天才
talented=adj.有天賦的
academy=n.[C]學院
academic=adj.學業的,學術的
afford=vt.買得起,負擔得起
fate=n.[U,C]命運
flip=vt.輕擲,輕拋;vt.掀,翻;n.[C]輕擲,輕拋
mine=n.[C]礦坑,礦場;vi.採礦,挖礦
miner=n.[C]礦工
devote=vt.致力,投入
devotion=n.[U]致力,投入
meanwhile=adv.在此同時,期間
harsh=adj.(環境)惡劣的、艱困的;adj.殘酷的,嚴厲的
tuition=n.[U]學費
grind=n.sing.苦差事;vt.磨碎,碾碎
triumph=n.[U]喜悅,志得意滿;n.[C]勝利
choke=vt.vi.(使)哽咽,(使)說不出話;vt.vi.噎到
bruised=adj.瘀傷的,碰傷的
bruise=vt.使瘀傷;n.[C]瘀傷
numb=vt.使遲鈍,使麻木;adj.麻木的,失去感覺的
grief=n.[U]悲傷,哀傷
grieve=vi.悲傷
sob=vi.啜泣;n.[C]啜泣
tribute=n.[C,U]悼念,致意
ambition=n.[C]抱負,夙願;n.[U]志向,野心
ambitious=adj.有野心的
prayer=n.[U]祈禱;n.[C]禱詞
pray=vi.祈禱
make ends meet=勉強維持生計
depend on=取決於
fortune smiles on ~=好運降臨在…身上
in vain=徒勞無功
make a name for oneself=成名
choke back=強忍住,抑制
hold out=伸出,遞出
