college=n.[U]學院,大學
tray=n.[C]托盤
tedious=adj.單調乏味的
elegant=adj.優雅的,典雅的
spill=vt.使灑出,使潑出;n.[C]灑出量,溢出量
colleague=n.[C]同事,同僚
graduate=vi.畢業;n.[C]畢業生
graduation=n.[U]畢業
orchard=n.[C]果園
prune=vt.修剪 (樹枝)
vine=n.[C]藤,藤蔓
blazing=adj.炎熱的,炙熱的
blaze=vi.熊熊燃燒;n.[C](usu.sing.)大火,烈火
bend=vi.(bent | bent | bending)彎腰,傾身;vi.轉彎,拐彎;n.[C]拐彎,彎道
cooperation=n.[U]合作,協作
cooperate=vi.合作,協作
cooperative=adj.合作的
resume=n.[C]履歷,簡歷
applicant=n.[C]申請人
proficiency=n.[U]熟練,精通
eligible=adj.合格的,有資格的
supplement=vt.補充,增補;n.[C]補充物,補給品
youngster=n.[C]少年
globe=n.sing.(the ~)地球;n.[C]地球儀
global=adj.全球的,全世界的
broaden=vt.增長 (知識、經驗等);vt.使變寬
horizons=n.pl.眼界,視野
horizon=n.sing.(the~)地平線
horizontal=adj.水平的,橫的
enhance=vt.提高,增強
enhancement=n.[U]提高,增強
worthwhile=adj.值得 (花金錢、時間、精力)的
racial=adj.種族的
race=n.[C]種族
discrimination=n.[U]歧視
discriminate=vi.歧視
see for oneself=親自看看
by and large=大體上,一般而言
go without saying (that)=不用說,顯而易見
set off=動身,啟程
the upper hand=優勢
gear up=做好準備
