tug=vi.(tugged | tugged | tugging)拉,拽;n.[C]拉,拽
sleeve=n.[C]袖子
plantation=n.[C]種植場
inject=vt.注射
injection=n.[C]注射
pest=n.[C]害蟲
boost=vt.改善,促進;n.[C](usu.sing.)改善,促進
harvest=n.[C]收成,收穫量;vt.收穫,收割
reload=vt.再裝填
load=vt.裝滿,裝入;n.[C]裝載量
barrel=n.[C]桶
spray=vi.噴灑
infertility=n.[U]不孕
infertile=adj.不孕的
disclose=vt.揭露,公開
disclosure=n.[U]揭露,公開
ban=vt.(banned | banned | banning)禁止;n.[C]禁令
register=vt.註冊,登記;n.[C]登記表
registration=n.[U]註冊,登記
export=vt.輸出,出口;n.[U]出口
yield=n.[C]產量,收益;vt.產出,獲利
decline=vi.衰退,下降;n.[U]減少,衰落
poison=n.[U]毒物;vt.毒害,毒殺
poisonous=adj.有毒的
staff=n.[C](usu.sing.)全體員工
reluctant=adj.不情願的,無可奈何的
exposure=n.[U]暴露,接觸;n.[U]關注,宣傳
bubble=vi.(of an emotion or a feeling)強烈感受到,持續存在;vi.冒泡,起泡;n.[C]泡沫,氣泡
disregard=vt.忽視,無視
illuminating=adj.富啟發性的
illuminate=vt.(fml.)闡明,解釋;vt.照亮
innocent=adj.天真無邪的,純真的;adj.(of a person)清白的,無罪的
innocence=n.[U]清白,無罪
compel=vt.(compelled | compelled | compelling)強迫,迫使
campaign=n.[C]運動,活動;vi.發起活動,參與運動
day in, day out=日復一日
flash back (to something)=回想起 (某事)
be lost for words=(因驚訝、難過等)說不出話,無言
black out something=封鎖 (資訊、消息等)
day after day=每天,一天天
in accord (with ~)=(fml.)(與…)一致,融洽
along ~ lines=以…的方式
