generation=n.[C]世代,一代
intolerable=adj.無法忍受的
tolerable=adj.可忍受的
tolerate=vt.容忍,忍受
tolerance=n.[U]容忍,忍受
laundry=n.[U](待洗或洗好的)衣物
housework=n.[U]家事,家務
racial=adj.種族的
slave=n.[C]奴隸
separate=vt.分隔,分開;adj.分開的,單獨的
separation=n.[C]分離,離別
settlement=n.[C]定居地;n.[C]協議
settle=vt.解決,結束(爭論、爭端等)
prison=n.[U]監獄,牢獄
prisoner=n.[C]囚犯,犯人
slight=adj.輕微的,少量的
labor=n.[U]勞動,粗活;n.[U]勞工,工人;vi.辛勤工作
servant=n.[C]僕人,傭人
suffer=vi.遭受,承受;vi.受苦
enormously=adv.非常,很
enormous=adj.巨大的
ashamed=adj.感到羞恥、慚愧的
sexual=adj.與性有關的;adj.性別的
sex=n.[U]性別
depressed=adj.沮喪的,意志消沉的
depress=vt.使沮喪
depression=n.[C]沮喪
mental=adj.精神上的,心理的
commit=vt.(committed | committed | committing)犯(罪或錯誤);vt.承諾,保證
suicide=n.[U]自殺
impact=n.[C](usu.sing.)影響;n.[U]撞擊,碰撞
scale=n.sing.規模
unfair=adj.不公平的
fair=adj.公平的
respect=vt.尊重,謹慎對待;vt.尊敬,仰慕;n.[U]尊敬
tear apart ~=將…拆散
beyond belief=令人難以置信
result in something=導致某事發生
regardless of ~=不管…,不顧…
come together=成群結隊
have something to offer (someone)=某事物(對某人)有可取之處
