general=adj.一般的,非專門的;adj.普遍的,一般的
derive=vi.起源於;vt.得到,獲得
release=vt.公開發行;vt.釋放;n.[U]公開發行;n.[U]釋放,排放
feature=vt.以…為特色;n.[C]特色,特點
gossip=n.[U]流言,八卦;vi.散播流言,說八卦
reveal=vt.洩漏,透露
chase=vt.vi.追逐;n.[C]追逐
brand=n.[C]品牌
image=n.[C]影像;n.[C]形象
edit=vt.編輯
edition=n.[C]版本
modify=vt.修改
modification=n.[C,U]修改
digitally=adv.數位地
digital=adj.數位的
combine=vt.vi.結合
combination=n.[C,U]結合
standard=adj.標準的;n.[C,U]標準
widespread=adj.廣泛的
usage=n.[U](語彙的)用法
constantly=adv.持續地
constant=adj.持續的,不斷的
alternative=adj.另類的,非傳統的;adj.替代的;n.[C]選擇,替代方案
existing=adj.現有的,現存的
exist=vi.存在
existence=n.[U]存在
take on=開始具有
later on=之後
in the beginning=起初
too ~ to ~=太…而無法…
play a/an ~ role (in)=扮演…的角色
think up=想出
