ski=n.[C]滑雪板;vi.滑雪
leather=n.[U]皮革
kit=n.[C]成套工具,成套配備
vocal=adj.嗓音的,聲音的
immensely=adv.極度,非常
immense=adj.極大的,巨大的
mislead=vt.(misled |misled | misleading)使誤信,誤導
classification=n.[U]分類,歸類
classify=vt.(classified | classified | classifying)劃分,分類
stereotype=vt.對…有刻板印象;n.[C]刻板印象,成見
overlook=vt.沒注意到,忽略
identical=adj.ㄧ模ㄧ樣的,完全相同的
series=n.[C](usu.sing.)(pl.～)(廣播或電視上的)系列節目,一系列,ㄧ連串
neglect=vt.忽略,疏忽;n.[U]忽略,疏忽
adolescent=n.[C]青少年
adolescence=n.[U]青春期
manners=n.pl.禮貌,禮儀
manner=n.sing.方式,方法
sloppy=adj.(sloppier | sloppiest)不認真的,馬虎的
publication=n.[C]出版物,出版品;n.[U](書報/刊物等的)出版,發行
unethical=adj.不道德的
ethical=adj.合乎道德的,有關道德的,倫理的
ethics=n.pl.道德規範
merchant=n.[C]商人
distort=vt.曲解,扭曲,使變形,扭曲
basis=n.sing.原因,緣故;n.[C](pl. bases)基礎,根據
nationality=n.[U]國籍
orientation=n.[U](個人的)觀點,取向
orient=vt.以…為目標,以…為重點
prejudice=n.[U]成見,偏見
acknowledge=vt.承認
acknowledgement=n.[U]承認
monopoly=n.sing.專利,獨占;n. [C]專營,壟斷
peculiar=adj.奇怪的,怪異的
accent=n.[C]口音,腔調
glamour=n.[U]魅力
paste=vt.黏貼
get around=四處走動,旅行;(消息、訊息等)傳開,流傳
work on something=致力於某事
have no need of something=不需要某物
put (something) to (good) use=有效利用(某物)
read (something) into something=(對某事物)過度解釋、解讀
go by something=遵循某事物,遵從某事物
have a way of doing something=…是常有的事,有…的習慣
act on something=根據某物行事
two peas in a pod=(infml.)一模一樣
be supposed to=(依規定、安排等)應當,該;一般認為
