lately=adv.最近,近來
assure=vt.向…保證
assurance=n.[C]保證
disagree=vi.不同意
disagreement=n.[C,U]意見不合,爭論
challenge=vt.質疑;vt.向…提出挑戰;n.[C]挑戰
explain=vi.vt.解釋
explanation=n.[C,U]解釋
desperately=adv.極度,相當
desperate=adj.相當渴望的;adj.非常的,極端的
engagement=n.[C]重要的約會
engaged=adj.已經訂婚的
engage=vi.參與、從事某事
furthermore=adv.除此之外
depart=vi.離開
departure=n.[C]離開
hardly=adv.幾乎不
declare=vt.表明,宣告
declaration=n.[C]宣言,宣告
curious=adj.好奇的
curiosity=n.[U]好奇心
inform=vt.通知
describe=vt.描述
description=n.[C,U]描述
propose=vi.向…求婚;vt.提議
proposal=n.[C]求婚;n.[C]提議
argue=vi.爭論
argument=n.[C]爭論
shoot=vt.發射
confuse=vt.使人困惑
confusion=n.[U]困惑
be in love (with~)=愛上…,與…相愛
be filled with=充滿
on one’s way (to~)=在某人前往…的途中
cut (~) off=阻斷
show up=現身
