suburb=n.郊區
suburban=adj.郊區的
density=n.密度
dense=adj.密集的,稠密的
crammed=adj.塞滿的
cram=vt.把…塞進
boom=vi.(商業等)繁榮,(城市等)迅速發展,發出轟隆聲;n.繁榮,興盛
weave=vt.把…編進…,編織
primary=adj.首要的,主要的
vast=adj.廣大的,大量的
errand=n.差事
withdraw=vt.提款;vi.退出
deposit=vt.存款;n.存款
install=vt.安裝,設置
installation=n.安裝
range=vi.範圍包括,n.範圍,界限
cuisine=n.菜餚
strategy=n.對策,策略
strategic=adj.策略的,戰略的
translator=n.譯者,翻譯
translate=vt.翻譯
translation=n.翻譯,翻譯作品
document=n.文件,公文;vt.記錄,記載
documentary=adj.文件的,文獻的
gum=n.口香糖
counter=n.櫃檯
reliable=adj.可靠的,可信賴的
supplies=n.生活必需品
supply=n.供應量,供給量
supply=vt.提供,供給
stack=vt.整齊堆放;n.(整齊的)一堆,ㄧ疊
combine=vt.結合,組合
combination=n.結合,組合
promotion=n.宣傳,推銷,(職位等)晉升,升遷
promote=vt.促銷,宣傳
tempt=vt.引誘,吸引
temptation=n.引誘
stimulate=vt.促進,激發,激發對…的興趣
stimulation=n.激發(興趣)
maximize=vt.最大化,使增加到最大限度
maximum=n.最大值,最大量;adj.最大值的,最大量的
profit=n.利潤,收益
profitable=adj.有利潤的
