racist=adj.種族歧視的
racism=n.種族歧視
occupy=vt.佔領,佔據,使用,佔用
occupation=n.佔領,佔據
badge=n.徽章,標記
readily=adv.快速地,輕而易舉地
concealment=n.隱藏,隱匿
conceal=vt.隱藏,隱匿
duration=n.持續時間
pastime=n.消遣,娛樂
namely=adv.也就是
wage=n.工資,薪水
monotonous=adj.單調的,乏味的
monotony=n.千篇一律,單調乏味
giggly=adj.咯咯笑的,傻笑的
giggle=vi.咯咯地笑,傻笑
brutal=adj.殘暴的,兇殘的
backpack=n.背包,行囊
snatch=vt.搶去,奪去
sealed=adj.密封的,封閉的
seal=vt.封上,封住
dread=n.害怕,畏懼;vt.害怕,畏懼
dreadful=adj.可怕的
sow=vt.撒下,播下,播種
slaughter=vt.屠殺;n.屠殺
gnaw=vi.(不停地)咬,啃
lessen=vt.降低,減輕
throng=n.ㄧ大群人,人群;vt.湧入,蜂擁而至
soberly=adv.嚴肅地,冷靜地
sober=adj.嚴肅的,冷靜的;vi.變得嚴肅,冷靜
betray=vt.出賣,洩漏(機密),辜負,背叛
capture=vt.擄獲,捕獲;n.逮捕,抓住
sole=adj.單獨的,唯一的
