arrest=vt.逮捕;n.[U]逮捕
criminal=adj.(涉及)犯罪的;n.[C]罪犯
crime=n.[C]罪
jail=n.[U]監獄;vt.監禁,將…關進監獄
exhausted=adj.疲憊的,筋疲力竭的
exhaust=vt.使疲憊,使筋疲力竭
suspicion=n.[U]不信任;n.[C]懷疑,猜疑
suspicious=adj.懷疑的,猜疑的
inquire=vi.詢問,打聽
inquiry=n.[C]詢問,打聽
submit=vt.(submitted | submitted | submitting)提交,呈交
glance=vi.迅速瀏覽;vi.掃視,瞥一眼;n.[C]掃視,瞥一眼
convict=n.[C]囚犯,罪犯;vt.(經審判)證明…有罪,宣判…有罪
depart=vt.離開,從…出發
departure=n.[U]動身,出發
hostile=adj.有敵意的,不友善的
arouse=vt.喚起,激起
arrival=n.[U]抵達,到來
shiver=vi.顫抖,發抖
stamp=vi.重步行走
palace=n.[C]宮殿,宅邸
identity=n.[C]身分
precious=adj.珍貴的,貴重的
courtesy=n.[U]禮貌
temporary=adj.暫時的
disturb=vt.使煩惱,使覺得困擾;vt.干擾,打擾
disturbance=n.[C]干擾
pop=vi.(popped | popped | popping)(of one's eyes)(眼睛)瞪大;vi.發出砰的一聲
stun=vt.(stunned | stunned | stunning)使震驚,使驚訝
mercy=n.[U]仁慈,寬容
transfer=vt.(transferred | transferred | transferring)轉讓;vi.轉調,調任;n.[C]轉調,調任
belongings=n.pl.個人物品,所有物
evil=n.[U]惡,邪惡;adj.邪惡的
gloom=n.[U]沮喪,憂鬱;n.[U]昏暗,黑暗
somehow=adv.不知什麼原因;adv.以某種方式
dismiss=vt.屏除,排除
hatred=n.[U]厭惡,憎惡
look someone up and down=上下打量某人
the talk of something=某地街談巷議的話題,眾人談論的焦點
reach out to someone=向某人伸出援手
drive out …(of something)=驅趕…(離開某處)
belong to …=是…的一員;屬於…
sink into something=陷入某狀態
all at once=忽然,突然之間
cast out …=驅逐…,趕走…
