society=n.[U]社會
social=adj.社會的
citizen=n.[C]公民
responsibility=n.[C]職責,義務;n.[U]負責,責任
responsible=adj.負責的
profession=n.[C]職業
professional=adj.職業的;n.[C]專家
relax=vi.休息,放鬆
relaxation=n.[U]休息,放鬆
duty=n.[C]義務,職責
rescue=vt.援救,營救;n.[U]援救,營救
nevertheless=adv.儘管如此,然而
rush=vi.急速行進,倉促行事;n.sing.匆忙,趕緊
patient=n.[C]患者,病人
instead=adv.作為替代,反而
daily=adj.每天的
situation=n.[C]情形,狀況
require=vt.需要
requirement=n.[C]必需品
actual=adj.實際的,確切的
legal=adj.與法律有關的,法律上的;adj.合法的
blame=vt.怪罪,責備;n.[U]怪罪,責備
arise=vi.出現
normally=adv.通常,正常
normal=adj.正常的,一般的
occur=vi.發生
reluctant=adj.不情願的
take on something=phr.接受(工作),承擔(責任),開始呈現具有(某種特質或外觀)
rely on…=phr.依賴,仰賴
lend a helping hand=phr.伸出援手
even though=phr.雖然
come across…=phr.偶然遇見,發現
walk away=phr.一走了之,脫身,
make a difference=phr.有影響,起作用
