source=n.[C]出處,來源
assassinate=vt.(政治)暗殺
ascend=vt.(fml.)上升,登上
throne=n.[C](the ~)王位
accordingly=adv.因此,於是
vow=vi.誓言要,立誓;n.[C]誓言
stepfather=n.[C]繼父
contemplate=vt.考量,思量
contemplation=n.[U]深思,沉思
burden=n.[C](usu.sing.)負擔,重擔;vt.使負擔,使煩惱
agony=n.[U]極度痛苦、痛楚
hasty=adj.倉促的,草率的
haste=n.[U]倉促,匆忙
crown=n.[C](the ~)王權,王位;vt.為…加冕
endure=vt.忍受,忍耐
endurance=n.[U]忍受,忍耐
torment=n.[U]折磨,痛苦;vt.折磨,使痛苦
intolerable=adj.不能忍受的,無法容忍的
tolerable=adj.可忍受的,可接受的
profound=adj.深奧的;adj.深刻的,深遠的
adviser=n.[C]顧問
constructive=adj.有建設性的
construct=vt.建築,建造
construction=n.[U]建設,建造
heed=vt.(fml.)聽從,注意;n.[U]留心,注意
intimate=adj.親密的,密切的
intimacy=n.[U]親密,密切
prudent=adj.謹慎的,審慎的
royal=adj.王室的,皇家的
royalty=n.[U]王室成員
status=n.[U]地位,身分
diplomatic=adj.外交的
diplomacy=n.[U]外交,外交手段
diplomat=n.[C]外交官
magnificent=adj.值得讚揚的,壯麗的
literature=n.[U]文學,文學作品
revenge oneself on someone=(fml.)向某人報復,對某人報仇
settle a/the score (with someone)=報復 (某人),(和某人)算帳
point of view=觀點
open one's heart (to someone)=(向某人)敞開心扉
all the time=一直,始終;經常
lose one's heart (to someone)=(fml.)愛上 (某人)
warn someone off (something)=告誡某人不要…
