apologize=vi.道歉
apology=n.道歉
delay=n.耽擱,延誤;vt.耽擱,延誤
continuously=adv.持續不斷地
continuous=adj.持續不斷的,不間斷的
continual=adj.頻頻的,一再發生的
ignore=vt.忽視,不注意
furious=adj.狂怒的,暴怒的
crush=n.迷戀,擁擠的人群;vt.壓扁,壓碎
separate=vt.分隔,分開;adj.分開的,單獨的
separation=n.分離,離別
download=vt.下載
dependence=n.依賴,依靠
technological=adj.科技的
technology=n.科技
luxury=n.奢侈品,奢侈,奢侈的享受
luxurious=adj.奢華的,極為舒適的
addict=n.沉迷於…的人,對…上癮的人,有毒癮的人
addiction=n.沉迷,上癮
psychological=adj.(關於)心理學的,心理的,精神上的
psychology=n.心理學
psychologist=n.心理學家
term=n.用語,術語
isolated=adj.孤單的,感到孤立的
isolate=vt.隔離,孤立
isolation=n.隔離,孤立
access=n.(使用某物､見到某人的)機會;vt.存取(電腦資料､數據等)
contact=n.聯絡人,聯繫,聯絡;vt.聯繫,聯絡
emergency=n.緊急狀況
promptly=adv.迅速地,即時地
prompt=adj.迅速的,立即的
suffer=vi.受苦;vt.遭受,承受
frequently=adv.常常地,頻繁地
frequent=adj.常常的,頻繁的
message=n.訊息,消息
messenger=n.送信人,信差
insist=vi.堅持,執意
clever=adj.好用的,巧妙的,機靈的,聰穎的
concentrate=vi.專心,集中注意力
concentration=n.專心,專注
