champion=n.[C]冠軍
dedication=n.[U]奉獻,投入
dedicate=vt.把…奉獻於,將…投入於
medal=n.[C]獎牌
injury=n.[C,U]受傷
injure=vt.使…受傷
success=n.[U]成功;n.[C]成功的人、事物
succeed=vi.成功辦到
successful=adj.成功的
pain=n.[U,C]疼痛
painfully=adv.痛苦地
painful=adj.疼痛的;adj.令人痛苦的
immediately=adv.立即,馬上
immediate=adj.立即的
collapse=vi.倒下;vi.倒塌;n.[U]倒塌
medical=adj.醫療的
staff=n.[U,C]全體員工
somehow=adv.以某種方式
courage=n.[U]勇氣
strength=n.[U]意志力;n.[U]體力,力量
strengthen=vt.強化
support=n.[U]支持;vt.支持;vt.支撐
struggle=vi.艱難地前進;vi.奮力,爭取;n.[C]奮鬥,努力
pride=n.[U]驕傲,得意
proud=adj.驕傲的,得意的
emotional=adj.情緒激動的;adj.(only before noun)情緒的,情感的
emotion=n.[C,U]情緒,情感
admiration=n.[U]欽佩
admire=vt.欽佩
respect=n.[U]尊敬,尊重;vt.尊敬,尊重
take off=(1)出發;(2)起飛
have one’s heart set on=一心一意想要做某事
speed (~) up=加速
rise to one’s feet=(重新)站起來
carry ~ through=幫助…渡過難關
