scar=n.[C]傷疤,傷痕;vt.(scarred | scarred | scarring)使留下傷疤
objective=n.[C]目標,目的
observe=vt.(fml.)觀察到,看到
observation=n.[U]觀察
physical=adj.身體的,肉體的
defect=n.[C]缺點,缺陷
participant=n.[C]參與者,參加者
participate=vi.參與,參加
participation=n.[U]參與,參加
sticky=adj.黏的
stick=vt.(stuck | stuck | sticking)黏住,貼上
clinic=n.[C]診所
peep=vi.窺視,偷看;n.[C](usu.sing.)偷看,一瞥
assumption=n.[C]假設,臆測
assume=vt.假設,認為
inevitably=adv.無可避免地,必然地
inevitable=adj.無法避免的,必然的
inferiority=n.[U]低等,劣勢
inferior=adj.次等的,比不上的
bound=adj.肯定會,極有可能
confront=vt.面臨,遭遇 (問題、困難)
confrontation=n.[U]衝突,對峙
crisis=n.[C](pl.crises)危機,緊要關頭
bruise=vt.使受挫,打擊;vt.使受瘀傷;n.[C]瘀青,擦傷
ego=n.[C]自我意識
hence=adv.(fml.)因此
limb=n.[C]肢,臂,腿,翼
intend=vt.計畫,想要
intention=n.[U]意圖,打算
intent=n.[U](fml.)目的,意圖
beam=vi.眉開眼笑
despite=prep.儘管,即使
deficient=adj.(fml.)有缺點、缺陷的
deficiency=n.[C]缺點,缺陷;n.[U]缺乏,不足
embrace=vt.(fml.)接受(想法、觀念等);vt.(fml.)擁抱;n.[C]擁抱
mere=adj.僅僅的,只不過
pimple=n.[C]面皰,粉刺
steer=vt.引導,率領;vt.駕駛 (汽車、船等)
stir up something=挑起…,煽動…
sweep away something=徹底消除…,消滅…
in reality=事實上
in the course of time=總有一天,最終
know no bounds=(of an emotion or quality)無窮無盡
to the fullest=充分地
deprive ~ of something=從…剝奪某物,使…失去某物
