reputation=n.名譽,名聲
legendary=adj.極富盛名的
poetry=n.詩
poetic=adj.詩的,詩歌的
verse=n.詩,韻文,詩節,歌曲的段落
manifest=vt.顯示,表明;adj.明顯的,明白的
aptitude=n.天資,天賦
prime=adj.典型的,具代表性的,首要的,最重要的
tread=vi.踩,踏
sigh=n.嘆息;vi.嘆息,嘆氣
hence=adv.從此時起,…之後
stroll=vi.散步,蹓達;n.散步,蹓達
route=n.路徑,路線
companion=n.同伴,夥伴
companionship=n.友誼,交情
mutter=vt.嘟囔,嘀咕
gorgeous=adj.非常漂亮的,美麗動人的
scenery=n.景色,風景
scenic=adj.景色優美的,風光秀麗的
initial=adj.最初的,開始的
depict=vt.描繪,描寫
dilemma=n.進退兩難,左右為難
narrator=n.敘述者,旁白
narrate=vt.敘述,講(故事)
narrative=n.故事
superficially=adv.從表面上看來
superficial=adj.表面的,粗略的,粗淺的
recount=vt.敘述,描述
inner=adj.內心的,內在的,內部的,裡面的
arouse=vt.激發,喚起(興趣､情感等)
hardship=n.艱難,困苦
option=n.選擇,可選擇的東西
optional=adj.供選擇的,可選擇的
