ability=n.[C]能力
heal=vt.癒合,痊癒;治癒,化解(心理問題)
percent=n.[C](pl.)百分之一
percentage=n.[C]百分比,百分率
emotion=n.[C]感情,情緒
emotional=adj.情感上的
mental=adj.心智的,心理的
attitude=n.[U]心態,態度
weaken=vt.使衰弱,減弱
focus=vi.集中(注意力等);n.sing.(注意力等的)焦點,中心
response=n.[C]回應,反應;回答,答覆
respond=vt.回答,答覆
laughter=n.[U]笑,笑聲
claim=n.[C]聲稱,宣稱;vt.聲稱,宣稱
relax=vt.使鬆弛,鬆開;vi.休息,放鬆
relaxation=n.[U]休息,放鬆
muscle=n.[C]肌肉
complicated=adj.複雜的
complicate=vt.使複雜化
equipment=n.[U]設備,器材
equip=vt.配備,裝備
provide=vt.提供,給予
rate=n.[C]速率
normal=n.[U]正常;adj.正常的
internal=adj.體內的,內心的
production=n.[U](自然)產生;製造
produce=vt.(自然地)產生
product=n.[C]產品
comedy=n.[C]喜劇
comedian=n.[C]喜劇演員
include=vt.使成為…的一部分;包括,包含
including=prep.包括,包含
pain=n.[U](身體的)疼痛
painful=adj.令人疼痛的,引起痛苦的
reduction=n.[U]降低,減少
reduce=vt.降低,減少
fight off something=擊退…,克服…
on the other hand=另一方面
back up ~=支持…,證實…
first of all=第一,首先
up to something=(數量、程度等)至多可達…
refer to ~ as something=將…稱作某物
what is more=再者,而且
