physics=adj.有娛樂性的,有趣的
physical=adj.物理學的;adj.身體的,肉體的
chemistry=n.[U]化學
recognize=vt.認可
recognition=vt.辨認,認出;n.[U]辨認,認出
committee=n.[C]委員會
annually=adv.每年一次
annual=adj.一年一次的
peace=n.[U]和平
peaceful=adj.和平的
invention=n.[C]發明
invent=vt.發明
inventor=n.[C]發明家
honor=vt.授以…的榮譽;n.sing.光榮,榮幸
damage=n.[U]破壞,損害;vt.破壞,損害
unusual=adj.與眾不同的,不尋常的
usual=adj.通常的
judge=n.[C]評審,裁判;vt.評價,評定
judgment=n.[C]判斷,評價
spirit=n.sing.精神,心態
spiritual=adj.精神(上)的
mood=n.[C]情緒,心情
cough=vi.咳嗽;n.[C]咳嗽症狀
stage=n.[C]舞臺;n.[C]階段,時期
rude=adj.粗魯的,無禮的
whenever=conj.每當,每次
host=n.[C]節目主持人;n.[C]主人;vt.主持,主辦
tease=vt.揶揄,戲弄
humor=n.[U]幽默
humorous=adj.幽默的
grab=vt.(infml.) 使…感興趣,吸引;vt.抓住
revolution=n.[C]重大變革
revolutionary=n.[C]革命運動;adj.革命性的
investigation=n.[C]調查,偵查
investigate=vt.調查,偵查
anything but=絕非,根本不
in reality=事實上
hand out something=分發某物
look for ~=尋找…
in keeping (with something)=(與某事物)一致
drag on=拖得太久
