nervous=adj.緊張的,擔憂的
pound=vi.(心臟)狂跳,怦怦跳;敲打,重擊
communicate=vi.溝通;交流,聯繫
communication=n.[U]溝通
hall=n.[C](建物內的)走廊
medal=n.[C]獎牌,獎章
costume=n.[C]戲服
role=n.[C](演員的)角色;職責,作用
drama=n.[C]戲劇;戲劇性的事件
dramatic=adj.戲劇性的,誇張的
wonder=vt.想知道,感到納悶;vi.對…感到驚訝;n.[U]驚嘆,驚奇
chat=vi.(chatted | chatted | chatting)閒聊,聊天;n.[C]閒聊,聊天
principal=n.[C]校長
schedule=n.[C]計劃表,日程表;vt.為…安排時間,將…預定下來
personal=adj.個人的,自己的
belongings=n.pl.財物,財產
confused=adj.困惑的,糊塗的
confuse=vt.使困惑
confusion=n.[U]困惑
suddenly=adv.突然地
sudden=adj.突然的
seem=vi.看來,似乎
obvious=adj.明顯的,顯然的
reply=vt.(replied | replied | replying)回答,答覆;n.[C]回答,答覆
interrupt=vt.打擾,打岔
interruption=n.[U]打擾,干擾
plenty=pron.大量,許多
plentiful=adj.大量的,充足的
remind=vt.提醒;使回想,使想起
make friends (with someone)=和(…)交朋友
pluck up the courage (to do something)=鼓起勇氣(…)
as well (as ~)=也
by the way=(infml.)順帶一提
check out ~=查看…,檢查…
fit in=適應
