substantially=adv.非常,相當多地
substantial=adj.大量的,重大的
universe=n.sing.(the ~)宇宙
lifespan=n.[C]壽命
span=n.[C]一段時間;vt.持續,跨越某一段時間
collapse=vi.崩塌,瓦解;n.[U]倒塌,崩壞
compose=vt.(fml.)構成,組成;vt.創作 (音樂、詩歌等)
composition=n.[U]構成,組成
chunk=n.[C]大塊,厚片
particle=n.[C]微粒,微量
dust=n.[U]灰塵,塵土;vt.擦去灰塵
dusty=adj.滿是灰塵的
stray=adj.零星的,散亂的;adj.(of an animal)走失的,流浪的;vi.走失,偏離;n.[C]走失的寵物,無主的寵物
atom=n.[C]原子
atomic=adj.原子的
mystery=n.[C]神秘,不可思議的事物
mysterious=adj.神秘的
realm=n.[C]領域
astronomy=n.[U]天文學
astronomer=n.[C]天文學家
volume=n.[U]體積,容積;n.[U]音量
gleam=n.[C]微弱的光線;vi.發出微光,閃爍
bounce=vi.彈回,彈跳
triple=adj.三倍的;vt.使成為三倍,增至三倍
plunge=vi.驟然落下
bizarre=adj.古怪的,不尋常的
permanent=adj.永久性的,長久的
detention=n.[U]監禁,扣押
detain=vt.監禁,扣押
strand=n.[C](線、繩的)股,縷
shadow=n.[C]影子
emerge=vi.(從暗處、躲藏處)出現
dimension=n.[C]長、寬、高的度量,空間
no more than=僅僅
get away (from ~)=(從…)離開,(從…)逃離
What goes up must come down.=凡事有起有落。
break out (of something)=逃離 (某事物),擺脫 (某事物)
only if=唯若…才,只有當
on account of ~=(fml.)因為…
for sure=(infml.)肯定,一定
