press=n.[U]新聞媒體
freedom=n.[U]自由
democratic=adj.民主的
democracy=n.[U]民主,民主制度
significant=adj.重大的,顯著的
significance=n.[U]重要性,意義
government=n.[C]政府
govern=vt.統治,治理
individual=adj.個別的,單獨的;n.[C]個人
publish=vt.刊登;出版
publisher=n.[C]出版商
details=n.pl.詳情
detail=n.[C]細節,枝節;vt.詳細敘述,詳細說明
private=adj.個人的,私人的;自用的
privacy=n.[U]隱私
illustrate=vt.(用例子或圖片、照片等)說明
illustration=n.[C]例證,實例
poverty=n.[U]貧窮,貧困
struggle=n.[C]努力,奮鬥;vi.努力,奮鬥
pregnant=adj.懷孕的
pregnancy=n.[U]懷孕
urgent=adj.迫切的,緊急的
economic=adj.經濟上的
economy=n.[C]經濟情況
nonetheless=adv.(fml.)但是,儘管如此
fame=n.[U]名氣
overnight=adv.一夜之間,突然;adj.突然的,很快的
sum=n.[C]金額
exclusive=adj.獨家的,專有的
manufacturer=n.[C]製造商
manufacture=vt.大量製造;n.[U]大量製造
advertise=vt.登廣告,做廣告
advertisement=n.[C](＝ad)廣告
discuss=vt.討論,商量
discussion=n.[C]討論,商討
possibility=n.[U]可能,可能性
curiosity=n.[U]好奇心
curious=adj.好奇的
gossipy=adj.愛聊八卦的,說長道短的
gossip=n.[U]八卦,流言蜚語
resident=n.[C]居民
make use of ~=利用…,使用…
bring down someone=擊敗…,推翻…
on the way=(嬰兒)尚未出生;即將到來,就要發生
beyond belief=令人難以置信
make(the)headlines=成為重要新聞、頭條
press for something=不停要求某事物,持續要求某事物
to ~ extent=到達…的程度
