romance=n.[C]愛情關係;n.[U]愛意,戀愛
romantic=adj.浪漫的,愛情的
odds=n.pl.可能性
pressure=n.[U]壓力;n.[U]逼迫,脅迫;vt.逼迫,脅迫
pretend=vi.假裝
optimistic=adj.樂觀的
optimism=n.[U]樂觀,樂觀主義
cinema=n.[C]電影院
awful=adj.糟糕的
gallery=n.[C]畫廊,美術館
energetic=adj.精力充沛的
carefree=adj.無憂無慮的
lively=adj.(of an event or a place)熱烈的;adj.(of a person)活潑的,精力充沛的
awkward=adj.令人尷尬的
arrogant=adj.傲慢的,自負的
arrogance=n.[U]傲慢,自負
insecure=adj.感到不安的,沒有把握的
secure=adj.安心的,有把握的
security=n.[U]放心,穩妥
sympathetic=adj.同情的,有同情心的
sympathy=n.[U]同情 (心)
sympathize=vi.同情
yawn=vi.打哈欠
advisable=adj.建議的,明智的
advise=vt.建議,提出忠告
advice=n.[U]建議,忠告
demand=vt.需要;vt.強烈要求;n.[C]要求
flow=vi.(of words, ideas, conversations, etc.)流暢;vi.(of liquid, electric currents, or gas)流動;n.[C](usu.sing.)流動
steady=adj.穩定的;adj.持續的,漸進的
slight=adj.少量的,輕微的
previous=adj.先前的
respect=vt.尊重,謹慎對待;vt.尊敬,仰慕;n.[U]尊敬
respectful=adj.恭敬的,表示尊敬的
sincerity=n.[U]真誠,真心誠意
sincere=adj.真誠的
have one's eye on someone=看上…,看中…
what if ~=要是…會怎麼樣
as long as=只要
work out=(of a situation)成功地發展
be glued to something=(infml.)全神貫注看著…
come across=使人產生 (…的)印象
open up=暢所欲言,開誠布公
get over ~=從…中恢復常態
come along=抵達,出現
have something in common=(和某人的想法、興趣等方面)有共同之處/(和某物或某處的特點)有相同、相似之處
