adolescent=adj.青少年的,未成熟的;n.青少年
agricultural=adj.農業的
architect=n.建築師
architecture=n.建築學
astronaut=n.太空人,宇航員
beforehand=adv.事先,提前地
beneficial=adj.有益的,有利的
broaden=v.變寬,變闊,擴大
bully=v.脅迫,欺侮;n.恃強欺弱者,惡霸
carbon=n.碳,複寫紙
category=n.種類,類別
clause=n.(文件的)條款,子句
commodity=n.商品,日用品
commute=v.減刑,通勤;n.通勤
conduct=v.引導,帶領;n.行為,品行,舉動
destination=n.目的地,終點
discriminate=v.區分；差別對待
distinctive=adj.有特色的,特殊的
document=v.用文件證明;n.文件,證件
dreadful=adj.可怕的
embrace=v.擁抱,抓住(機會等);n.擁抱
ensure=v.保證,擔保
eternal=adj.永久的,永恆的
exaggeration=n.誇張
exceptional=adj.例外的,異常的,特殊的
excess=adj.過量的,額外的;n.超越,過量
executive=adj.執行的,行政部門的;n.執行者,業務主管
extension=n.伸長,擴大,延期
fabric=n.布料,織品
fertilizer=n.肥料
garment=n.服裝,衣著
gender=n.性別
glacier=n.冰河
graze=v.吃草,放牧,擦傷;n.吃草,放牧,擦傷
horizontally=adv.水平地,橫地
housing=n.房屋,住宅
interference=n.干涉,干預,擾亂
interpretation=n.解釋,詮釋
issue=v.發行,發佈;n.問題,爭論,發行(物)
layer=v.把…堆積成層;n.層,階層,地層
likelihood=n.可能,可能性
marine=adj.海的,海生的,海軍陸戰隊的;n.船舶,海運業,海軍陸戰隊隊員
massive=adj.厚實的,粗大的,大量的
noticeable=adj.顯而易見的,顯著的
outgoing=adj.直率的,往外的,即將離職的,友善的
outward=adj.向外的,往外去的;adv.向外,出海,出港
overall=adj.總的,全部的,adv.大體上;n.工作褲,工作服
overdo=v.把…做得過分,使過於疲勞
pacific=adj.(大寫)太平洋的,平靜的;n.(大寫)太平洋
participant=n.參與者
persist=v.堅持,固執
potential=adj.潛在的,可能的;n.可能性,潛力,潛能
preference=n.偏愛,優先(權)
profile=v.畫側面像,描出輪廓,寫傳略;n.側影,輪廓,人物簡介
prospect=v.勘探,找礦;n.預期,前途,盼望的事物
pulse=v.跳動,振動;n.脈搏,有節奏的跳動
purchase=v.買,購買;n.所購之物
pyramid=n.(常大寫)金字塔,三角錐
recommend=v.推薦,介紹
reminder=n.提醒者,催函
rival=adj.競爭的;v.與…競爭;n.競爭者
scan=v.審視;n.掃描
scent=v.嗅,聞;n.氣味,香味,蹤跡
series=n.連續,系列
specialist=n.專家,專科醫生
structural=adj.建築上的,建築用的,結構上的
substitute=v.用…代替,代替;n.代替物,代用品
sturdy=adj.結實的,健康的,堅固的
tempt=v.引誘,誘惑
wheelchair=n.輪椅
wither=v.枯萎,凋謝
yield=v.出產,使屈服,讓路;n.產量
