aid=n.幫助,援助;vt.幫助,援助
approach=vt.接近,靠近;n.接近,靠近
batter=vt.擊毀,猛擊
battered=adj.破舊的
blur=vt.使模糊不清;n.sing.模糊不清的事物
chain=n. 一連串,一系列;鍊條;vt.拴住,鎖住
chill=n. 寒氣,寒冷;vt.使感覺冷
chilly=adj.寒冷的,冷颼颼的
closure=n.停業,倒閉
content=adj.滿意的,滿足的;vt.使滿足,使滿意
contentment=n.滿意
dim=adj.(燈光)昏暗的,暗淡的;vi.變昏暗,變暗淡
due=adj.預期的,預計的
erase=vt.抹滅,消除；擦掉,抹去
flat=adj.(輪胎)漏氣的,洩氣的；平的,平坦的
freeze=vi.結冰
freezing=adj.極冷的
owe=vt.欠(錢)
repay=vt.報答；償還,歸還
reward=n.報酬,回報;vt.獎賞；酬謝
rob=vt.搶劫,盜取
robber=n.搶劫犯,強盜
robbery=n.搶劫,強盜
shabby=adj.破舊的,破爛的
slide=vi.悄悄地移動;n.sing.滑動,滑行
strand=vt.使滯留,使受困
thoughtful=adj.體貼的
towel=n.毛巾
trunk=n.(汽車)後車廂；樹幹
vision=n.視力,視線
whisper=vi.私語,耳語
whisper=n.私語(聲),耳語(聲)
be on one's feet=久站
be worried sick=極度擔心
drive off=(駕駛)駕車離去,(車輛)開走
hit home=使(某人)深切感受到
or so =大約
pay someone back (something)=償還某人(人情、恩惠)；償還某人(金錢)
pull up (something)=(駕駛)停車,(車輛)停止
roll down something=搖下(車窗)
think twice (about doing something)=三思而行,仔細考慮(…)
