intense=adj.激烈的,劇烈的;adj.極度的,強烈的
intensity=n.[U]強烈 (程度),強度
intensify=vt.(intensified | intensified | intensifying)使加強,加劇
debate=n.[C]辯論,討論;vt.(尤指正式地)辯論,討論
excellence=n.[U]優秀,傑出
expertise=n.[U]專業知識,專門技能
mastery=n.[U]精通,熟練
renowned=adj.著名的,有名望的
mount=vt.發起,舉辦
invasion=n.[C]湧入;n.[C]武裝入侵,侵略
invade=vt.武裝入侵,侵略
string=n.[C]一系列,一連串;n.[C]細繩,線;vt.(strung | strung | stringing)用線 (或細繩)串在一起
alter=vt.改變,更改
prior=adj.(fml.)在…之前,先於…;adj.在先的,先前的
author=n.[C]作者,作家;vt.(fml.)編寫,撰寫
biography=n.[C]人物傳記
formula=n.[C]方案,方法;n.[C]方程式
formulate=vt.規劃,制定
stagger=vi.搖搖晃晃地走,踉蹌;vt.使震驚,使大吃一驚
stream=n.[C]人流,流動;n.[C]小河,溪流;vi.流出,流淌
alien=adj.外國的,異族的;adj.陌生的,不熟悉的;n.[C]外星人
retreat=n.[C](usu.sing.)逃離,撤退;vi.撤軍,撤退
ceaselessly=adv.(fml.)不斷地,連續地
ceaseless=adj.(fml.)不斷的,連續的
cease=vt.(fml.)中止,停止
differentiate=vt.使不同,產生差異;vi.區別,分辨
formidable=adj.令人敬畏的
marvelous=adj.極好的,很棒的
marvel=n.[C]奇蹟
exception=n.[C]例外,除外
settle on ~=選定…,決定…
bring in someone=請某人做,讓某人參與
anything but=根本不,一點也不
go all out=全力以赴,卯足全勁
all told=總計,合計
set ~ apart (from ~)=使…~ 眾不同,使…突出
