dweller=n.[C]居住者,居民
dwell=vi.(fml.)居住
dwelling=n.[C]住處,住所
centigrade=adj.攝氏溫度的
machinery=n.[U](大型)機器,機械
generate=vt.產生,製造
generator=n.[C]發電機
reflectiveness=n.[U]反射
reflective=adj.反射的,反光的
detect=vt.察覺,發現
trend=n.[C]趨勢,傾向
satellite=n.[C]人造衛星;n.[C]衛星
evaluate=vt.衡量,評估
evaluation=n.[C]衡量,評估
decisive=adj.決定性的,關鍵的
interact=vi.(of a thing)互相影響,交互作用;vi.(of a person)互動,交流
interaction=n.[U]互相影響
humid=adj.(of weather or the air)潮溼的
humidity=n.[U]溼氣,溼度
disperse=vt.散布,分散
vegetation=n.[U]植物,植被
opposite=n.[C]完全不同、相反的人或事物;adj.截然不同的,完全相反的
notable=adj.顯著的,值得注意的
trap=vt.(trapped | trapped | trapping)保存 (氣體、液體、熱量等);vt.使困於 (危險環境);n.[C]陷阱,圈套
shallow=adj.淺的,不深的
layer=n.[C]層,表
annoyance=n.[C]令人惱怒的事;n.[U]惱怒,生氣
pave=vt.鋪設
pavement=n.[U]鋪設過的路面
emission=n.[C]排放物
emit=vt.(emitted | emitted | emitting)散發,發出
implementation=n.[U]實施,執行
implement=vt.實施,執行
investment=n.[U]投資
invest=vt.投資
cool off=使涼快,涼快下來;冷靜下來
send out something=發出 (熱、信號等)
step up something=使某事加速,使某物增加
put forward something=提出某事,提議某事;將某事提前
balance out (something)=抵銷 (某物),使 (某物)相等
