accommodate=v.為…提供住所
accommodation=n.住宿
arrest=v.逮補,拘留;n.逮補,拘留
brood=v.沉思,憂慮
convict=n.服刑中的囚犯;v.宣判某人有罪
deserve=v.值得,應該得到
dine=v.用飯,吃正餐
dreadful=adj.糟透的,討厭的
exchange=v.交換,交流;n.交換,交流
exhaust=v.使疲憊不堪,使筋疲力盡
exhausted=adj.疲憊不堪的,筋疲力盡的
gloom=n.鬱悶,絕望;n.黑暗,陰暗
gloomy=adj.鬱悶的,絕望的
humiliate=v.使蒙羞,出醜
humiliation=n.恥辱,屈辱
inquire=v.詢問,打聽
inquiry=n.詢問,打聽
jail=n.監獄
petty=adj輕微的,小的
pity=n.同情,憐憫;v.同情,憐憫
possess=v.擁有,持有
possession=n.所有物,財物
precious=adj.貴重的,珍貴的;adj.寶貴的,珍貴的
release=v.允許…離開,釋放;n.釋放
roam=v.漫無目的的遊盪,徘徊
shelter=n.庇護,暫時的住所;v.庇護,掩護
shiver=v.因寒冷害怕或激動而打顫,顫抖;n.打顫,顫抖
solemn=adj.鄭重的,莊嚴的;adj.表情嚴肅的
solemnly=adv.鄭重地,莊重地
somehow=adv.不知怎麼地adv,以某種方法
stun=v.使大吃一驚,使目瞪口呆
stunned=adj.驚愕的
suspect=v.懷疑(某事是事實);n.嫌疑犯
suspicion=n.不信任,懷疑
suspicious=adj.懷疑的
all at once=突然
belong to…=是…一類,屬於…
cast out…=驅逐…,趕走…
drive…out=驅離…
look someone up and down=批判性地打量某人
reach out to someone=向…伸出援手,對…提供援助
the talk of something=某地人人談論的話題
with open arms=熱情地,熱烈地
