nominate=vt.提名
nomination=n.[C]提名
nominee=n.[C]被提名人
sorrow=n.[U]悲傷
sorrowful=adj.悲傷的
perfectionism=n.[U]完美主義
perfection=n.[U]完美
revise=vt.修改,修訂
revision=n.[C](一項)修改,修正
curved=adj.蜿蜒的,彎曲的
curve=vi.彎曲,呈曲線;n.[C]曲線,彎曲 (部分)
sprint=vi.短距離快跑;n.[C]短跑比賽
pump=vi.(上下或內外)快速運動;vt.(用幫浦)輸送,抽吸;n.[C]幫浦,打氣筒
strikingly=adv.顯著地,明顯地
striking=adj.顯著的,明顯的
mobility=n.[U]易於行動的能力
mobile=adj.行動方便的
subtly=adv.巧妙地
subtle=adj.巧妙的;adj.隱約的,不易察覺的
paradox=n.[C]自相矛盾的人或事物
yearn=vi.渴望,嚮往
simultaneously=adv.同時地
simultaneous=adj.同時的,同時發生的
endeavor=vi.(fml.)努力,奮力;n.[C](fml.)努力,盡力
pedal=vi.騎腳踏車;n.[C]踏板
breakthrough=n.[C]突破,重大進展
milestone=n.[C]里程碑
sentimental=adj.帶有情感的,感情上的
sentiment=n.[U]感傷,多愁善感
prospect=n.sing.預期 (會發生的事),期盼;n.[U]可能性
prospective=adj.可能的,潛在的
beloved=adj.親愛的,深愛的
depart=vi.(fml.)出發,離開
departure=n.[U]出發,離開
guardian=n.[C]維護者,保護者
conscientious=adj.認真盡責的
heart and soul=全心全意
pull ahead (of ~)=領先 (…)
catch up (with someone)=追上 (某人), 趕上 (某人);達到 (與某人)相同的水準
give ~ free rein=給予…完全的自由
pull away (from something)=(從某處)騎走,(從某處)駛離
all along=一直,始終
