invent=vt.發明
invention=n.[U]發明;n.[C]發明物
inventor=n.[C]發明家
saying=n.[C]諺語
necessity=n.[U]需要,必要
necessary=adj.必要的
solution=n.[C]解決辦法
solve=vt.解決
explain=vt.解釋,說明
explanation=n.[C]解釋,說明
create=vt.創造
creation=n.[U]創造,創立
creator=n.[C]創造者
mechanic=n.[C]機械工,技工
mechanical=adj.機械的
design=vt.設計;n.[U]設計
designer=n.[C]設計師
automatically=adv.自動地
automatic=adj.自動的
control=vt.(controlled | controlled | controlling)操控,控制;管理,支配;n.[U]管理,支配
device=n.[C]裝置,設備
represent=vt.代表
representative=n.[C]代表,代理人
exhibition=n.[C]展覽會
exhibit=vt.展覽,展示
international=adj.國際的
brilliant=adj.非常成功的,傑出的
successful=adj.成功的
success=n.[C]成功的人或事物
succeed=vi.成功
result=n.[C]結果,成果;vi.(因…)發生,起因於
failed=adj.失敗的
fail=vi.失敗
failure=n.[U]失敗
experiment=n.[C]實驗,試驗;vi.進行實驗,試驗
experimental=adj.實驗性的
chemical=n.[C]化學物質,化學製品;adj.化學的
expectation=n.[C]期待,預期
expect=vt.期待,預期
disappointed=adj.失望的,沮喪的
disappoint=vt.使失望
disappointment=n.[U]失望
instead=adv.反而
convince=vt.使相信,使信服
frustrate=vt.使失意,使挫敗
frustration=n.[U]失意,挫敗
damage=vt.破壞,損害;n.[U]破壞,損害
spread=vi.(spread | spread | spreading)散佈,普及;n.[U]散佈,普及
come up with something=想出,提出(計畫、答案等)
before long=不久之後,很快
come from something=來自…,起源於…
in fact=實際上,事實上
turn out=發展為,結果是
occur to someone=某人想到…,想起…
deal with something=處理…,解決…
