triumph=n.[U,C]勝利;成就n.[U](因勝利而產生的)喜悅;得意
apply=vi.申請;報名
application=n.[U,C]申請;申請書
applicant=n.[C]申請人
instrument=n.[C]樂器n.[C]儀器;器具
somehow=adv.以某種方式;不知怎麼地
barely=adv.幾乎不
bare=adj.赤裸的
invaluable=adj.非常寶貴的
encouragement=n.[U]鼓勵;鼓舞
encourage=vt.鼓勵
discourage=vt.阻止;勸阻
concert=n.[C]音樂會
receive=vt.收到;獲得
dazzle=vt.使讚嘆;使傾倒vt.(強光)使目眩;使眼花
potential=n.[U]潛力,可能性;adj.潛在的,可能的
scream=n.[C]尖叫vi.尖叫
dizzy=adj.頭暈目眩的
overseas=adv.在海外;到海外adj.海外的
determination=n.[U]決心
determine=vt.決定;影響
faith=n.[U]信心;信任
faithful=adj.忠誠的;忠實的
pursue=vt.追求;從事vt.追逐;追捕
pursuit=n.[U]追求
tons of=大量;許多
look for=尋找
make a living=謀生
look forward to=期待
be/get carried away=陶醉;激動得無法自持
come out of=由…產生
as soon as=一…就…
