memorable=adj.難忘的,值得紀念的
prominent=adj.重要的,知名的
moderately=adv.普通地,一般地
moderate=adj.中等的,適度的
rent=vt.租用,租借;n.[U]租金
rental=n.[U]租賃,租用
furnished=adj.配有傢俱的
furnish=vt.佈置傢俱
tenderly=adv.溫柔地,慈愛地
tender=adj.溫柔的,慈愛的
oblige=vt.迫使,必須做
obligation=n.[C]義務,責任
crack=vi.(嗓音)變沙啞;vi.破裂;n.[C]裂痕,縫隙
progressively=adv.漸進地,持續地
progressive=adj.穩定發展的,逐步的
progress=vi.進步,進展;n.[U]進步,進展
mock=vt.嘲弄,譏笑
ridicule=vt.嘲笑,嘲弄
deny=vt.(denied | denied | denying)否認,否定
denial=n.[C]否認,否定
terror=n.[U]驚駭,恐懼
wings=n.pl.(the~)(舞臺)側面,側翼
vague=adj.模糊的,不清楚的
accompany=vt.(accompanied | accompanied | accompanying)伴奏,伴唱;vt.(fml.)伴隨,陪伴
orchestra=n.[C]管弦樂團
pause=vi.暫停,停頓;n.[C]暫停,停頓
announce=vt.宣布
announcement=n.[C]宣布
explode=vi.迸發 (感情);vi.爆炸
explosion=n.[C]爆炸
explosive=adj.易爆炸的
anxiously=adv.焦急地,憂慮地
anxious=adj.焦急的,憂慮的
anxiety=n.[U]焦慮,不安
imitation=n.[C]模仿,仿效
imitate=vt.模仿
deafening=adj.震耳欲聾的,大聲的
deafen=vt.使感到震耳欲聾
applause=n.[U]鼓掌,喝采
applaud=vi.鼓掌,喝采
fade out=使 (畫面)淡出,使 (聲音)漸弱
rely on ~=(為生活、生存)依賴…;信賴…,信任…
in preference to ~=而非…,並非…
cater to ~=滿足…,迎合…的需求
make fun of ~=嘲笑…,取笑…
go on=發生,進行
in place of ~=代替…,取代…
at home=自在,無拘無束
