disease=n.疾病,弊病
potentially=adv.可能地,潛在地
potential=adj.可能的;n.潛力
excessive=adj.過多的,過度的
excess=n.過多,過度
label=vt.標示;n.標籤,標記
alert=v.提醒;n.警報;adj.有警覺的
nutrient=n.養分
pedestrian=n.行人
respectively=adv.分別地,各自地
respective=adj.各自的
serving=n.(食物的)一人份
quantity=n.數量
overall=adv.大致上,整體而言;adj.整體的
devour=vt.狼吞虎嚥,吃光
aspect=n.層面
instantly=adv.立即,馬上
instant=adj.立即的;n.瞬間
furthermore=adv.此外,再者
universally=adv.普遍地
universal=adj.全世界的
barrier=n.障礙,妨礙
currently=adv.現在,當今
current=adj.現在的,當前的
opposition=n.反抗
oppose=vt.反對,抵制
figure=n.數字,數據,(重要的或有名的)人物
advocate=n.擁護者,提倡者;vt.提倡,主張
counter=vt.反擊
core=n.重點,核心,(水果的)果核
interpret=vt.解釋
interpretation=n.解釋
first and foremost=ph.首先
keep off something=ph.避免某物
on occasion=ph.偶爾,不時
at a single glance=ph.看一眼
lend oneself to something=ph.適合某物
food for thought=ph.引人深思的事物
above all=ph.最重要的是
