freedom=n.[U]自由
statue=n.[C]雕像
remove=vt.移除
celebration=n.[U]慶祝;n.[C]慶祝活動
celebrate=vi.vt.慶祝
present=vt.授予,贈送;vt.提交
presentation=n.[C]報告,介紹
independence=n.[U]獨立
independent=adj.獨立的
monument=n.[C]紀念碑
symbolize=vt.象徵,代表
symbol=n.[C]象徵
symbolic=adj.作為象徵的,象徵性的
represent=vt.作為…的象徵,代表
representation=n.[U,C]表現(形式),塑像
continent=n.[C]大陸,陸地,洲
ancient=adj.古代的,古老的
slavery=n.[U]蓄奴制,奴隸身分
slave=n.[C]奴隸
unfair=adj.不公正的,不公平的
treatment=n.[U]對待,待遇
tourist=n.[C]遊客
tourism=n.[U]旅遊業,觀光業
attraction=n.[C]有吸引力的事物或地點
attract=vt.招引,吸引
attractive=adj.吸引人的
globe=n.sing.地球,世界
global=adj.全球的,全世界的
even though=儘管
close to=將近
over time=隨著時間過去
as always=一直如此
