employ=vt.僱用
employer=n.[C]雇主
employee=n.[C]員工,受僱者
employment=n.[U]工作,受僱
corporation=n.[C](大)公司,集團公司
corporate=adj.(大)公司的
suffer=vi.受苦
terminal=adj.末期的;n.[C]航廈,月臺
illness=n.[C,U]疾病,生病
ill=adj.生病的
tremendously=adv.相當大地
tremendous=adj.相當大的
laughter=n.[U]笑,笑聲
frighten=vt.使驚嚇
fright=n.[U]驚嚇
contact=n.[U]接觸;n.[U]聯絡;vt.聯絡
germ=n.[C](usu.pl.)細菌
warmth=n.[U]熱情;n.[U]溫暖
frail=adj.虛弱的
prompt=vt.促使;adj.立即的
pale=adj.蒼白的
confine=vt.使離不開(床、輪椅等);vt.侷限,限定
sparkle=n.[C]神采,閃耀;vi.閃耀
hug=n.[C]擁抱;vt.擁抱
drowsy=adj.昏昏欲睡的
stretch=vt.伸出(手臂或腿);vt.伸長,拉長
refuse=vi.vt.拒絕
refusal=n.[U]拒絕
hesitate=vi.猶豫
hesitation=n.[U]猶豫
dress up=裝扮
pass on ~ to ~=將…傳給、轉交給…
cheer ~ up=使…振奮、高興
turn ~ down=拒絕…
be about to=即將,正要
after all=畢竟
make a difference=有所影響
