night market=夜市
video call=視訊電話
breakfast=早餐
aunt=阿姨,舅媽,姑姑,伯母
many=許多的
people=人們
kid=小孩
snack=小吃
enjoy=享受
grass=草地
line up=排隊
picnic=野餐
feed=餵食
take pictures=拍照
camera=照相機
paint=畫畫
puppy=幼犬
museum=博物館
sunny=晴天的
shop=商店
restaurant=餐廳
ticket=票
outside=在⋯外面
bridge=橋
also=也
art=藝術
joy=喜悅
concert=音樂會
showroom=展示廳
artwork=藝術品
selfie=自拍照
meadow=草坪
