anemia=貧血
anus=肛門
aorta=主動脈
apex=心尖
appendix=闌尾
cortex=皮質
diaphragm=橫膈膜
esophagus=食道
hormone=激素，荷爾蒙
hypertension=高血壓
insulin=胰島素
iris=虹膜
kidney=腎臟
larynx=喉
lens=水晶體
liver=肝臟
lung=肺臟
pancreas=胰臟
plasma=血漿
pupil=瞳孔
respiration=呼吸
stomach=胃
vein=靜脈
cornea=角膜
lacrimal gland=淚腺
retina=視網膜
cochlea=耳蝸
cochlea duct=耳蝸管
semicircular=半規管
nasal cavity=鼻腔
nasal septum=鼻竇
atrium=心房
ventricle=心室
coronary artery=冠狀動脈
pulmonary artery=肺動脈
systole=心縮期
diastole=心舒期
lymph node=淋巴結
thymus gland=胸腺
bone marrow=骨髓
platelet=血小板
hemoglobin=血紅素
white blood cell=白血球
leukocyte=白血球
lymphocyte=淋巴球
leukemia=白血病
thyroid cartilage=甲狀軟骨
maxillary sinus=上頜竇
pharynx=咽
vocal cord=聲帶
pleura=肋膜
trachea=氣管
upper gastrointestinal tract (UGI)=上腸胃道
duodenum=十二指腸
sigmoid colon=乙狀結腸
gallbladder=膽囊
renal pelvis=腎盂
nephron=腎元
glomerulus=腎絲球
renal tubule=腎小管
collecting tube=集尿管
aldosterone=醛固酮
rennin=腎素
perineum=會陰
ovary=卵巢
uterus=子宮
vagina=陰道
estrogen=雌性素
progesterone=黃體素
testes=睪丸
prostate gland=前列腺
scrotum=陰囊
vas deferens=輸精管
steroid=類固醇
growth hormone=生長素
thyroid gland=甲狀腺
parathyroid gland=副甲狀腺
adrenal cortex=腎上腺皮質
sex hormone=性激素
epinephrine=腎上腺素
pituitary gland=腦下腺(腦下垂體)
angiotensin=血管收縮素
