space=空間
large=大的
long=長的
shape=形狀
round=圓的
pack=一包
piece=一片
a lot=許多的
less=較少的
more=更多
some=一些
enough=足夠的
other=其它的
triangle=三角形
star=星形
size=尺寸
medium=中等的
kilogram=公斤
circle=圓圈
box=箱子
pair=一雙
a few=一些的(可數)
few=很少的(可數)
least=最少的
most=大部分的
any=任一的
every=每一個
several=幾個的
diamond=菱形
big=大的
small=小型的
pound=磅
line=線
package=包裹
part=部分
a little=一些的(不可數)
little=很少的(不可數)
many=許多的(可數)
much=許多的(不可數)
each=每個
only=唯一的
square=正方形
rectangle=長方形
