one=一
four=四
seven=七
ten=十
thirteen=十三
sixteen=十六
nineteen=十九
forty=四十
seventy=七十
hundred=百
count=計算
dozen=一打(12個)
second=第二
fifth=第五
eighth=第八
last=最後的
two=二
five=五
eight=八
eleven=十一
fourteen=十四
seventeen=十七
twenty=二十
fifty=五十
eighty=八十
thousand=千
number=數字,號碼
all=全部
third=第三
sixth=第六
ninth=第九
three=三
six=六
nine=九
twelve=十二
fifteen=十五
eighteen=十八
thirty=三十
sixty=六十
ninety=九十
million=百萬
half=一半
first=第一
fourth=第四
seventh=第七
tenth=第十
