time=時間
o'clock=點鐘
a.m.=上午
noon=中午
night=夜晚
day=一天
year=年
tomorrow=明天
Wednesday=星期三
Saturday=星期六
January=一月
April=四月
July=七月
October=十月
season=季節
autumn=秋天
fall=秋天
birthday=生日
festival=節慶
gift=禮物
future=未來
ago=在…之前
now=現在
later=後來
yet=還沒
once=一次
usually=通常
soon=不久
early=早
minute=分鐘
watch=錶
p.m.=下午
afternoon=下午
eve=前夕
week=星期
yesterday=昨天
Monday=星期一
Thursday=星期四
Sunday=星期天
February=二月
May=五月
August=八月
November=十一月
spring=春天
winter=冬天
holiday=節日
Christmas=聖誕節
present=禮物
before=以前
since=從…到現在
then=當時
during=在…期間內
still=仍然
again=再一次
often=時常
next=然後
late=晚
hour=小時
clock=時鐘
morning=早晨
evening=傍晚
tonight=今晚
month=月
today=今天
Tuesday=星期二
Friday=星期五
weekend=週末
March=三月
June=六月
September=九月
December=十二月
summer=夏天
date=日期
vacation=假期
celebrate=慶祝
past=過去
after=之後
until=到…為止
moment=瞬間
already=已經
seldom=幾乎不
always=總是
sometimes=有時候
finally=最後
