head=頭
ear=耳朵
tooth=牙齒
shoulder=肩膀
finger=手指
leg=腿
nod=點頭
hear=聽見
say=說
tell=告訴
sit=坐
smile=微笑
pick=挑選
voice=聲音
hair=頭髮
nose=鼻子
body=身體
arm=手臂
heart=心臟
knee=膝蓋
see=看見
listen=聆聽
speak=講話
touch=觸碰
think=思考
laugh=嘲笑
point=指出
sound=聲音
eye=眼睛
mouth=嘴巴
neck=脖子
hand=手
stomach=胃
foot=腳
look=看起來
smell=聞
talk=談話
walk=走路
blind=瞎的
hold=握住
brush=刷牙
burn=燙傷
