sport=體育活動
habit=習慣
interested=對…感興趣
baseball=棒球
player=運動員
jog=慢跑
draw=畫圖
paint=繪畫
basket=籃
band=樂隊
cover=封面
kite=風箏
song=歌曲
tape=錄音帶
break=打破
hit=打擊
play=玩
collect=收集
practice=練習
wake=醒來
exciting=刺激的
hurry=匆忙
loud=大聲的
soccer=足球
volleyball=排球
exercise=運動
rest=休息
favorite=最愛的
basketball=籃球
team=隊
art=藝術
movie=電影
picture=圖片
show=表演
camp=露營
doll=玩偶
magic=魔術
noise=噪音
ticket=票
climb=爬
jump=跳躍
run=跑步
hurt=疼痛
smoke=抽煙
win=成功
interesting=有趣的
quick=迅速地
use=使用
badminton=羽毛球
hobby=嗜好
interest=興趣
ball=球
tennis=網球
swim=游泳
dance=跳舞
music=音樂
picnic=野餐
sing=唱歌
comic=漫畫
game=遊戲
seat=座位
story=故事
toy=玩具
hide=隱藏
kick=踢
stand=站立
lead=指導
sleep=睡覺
lose=失去
fast=快速
slow=慢的
skate=溜冰
dodge ball=躲避球
