abysmal=adj.無底的,極差勁的
all-out=adj.盡全力的,徹底的
antagonistic=adj.敵對的不相容的
apace=adj.急速的
appalling=adj.可怕的,糟透的
astute=adj.精明的
awry=adj.背離正確方向的,異常的
ballistic=adj.勃然大怒的
benign=adj.無害的,有利的
breezy=adj.輕快的,無憂無慮的
bulky=adj.笨重的
cameo=adj.短暫而精采的
canny=adj.精明的
chagrined=adj.悔恨的,懊惱的
comely=adj.漂亮的
consecutive=adj.連續的
cutthroat=adj.(競爭)激烈的
cynical=adj.憤世嫉俗的
deadpan=adj.撲克臉孔的,不帶個人感情的
demure=adj.矜持的
dubious=adj.存疑的,不確定的
edgily=adv.焦急地,焦躁地
eerily=adv.怪異地
engaging=adj.吸引人的,有趣的
engrossing=adj.使全神貫注的,有趣的
feisty=adj.精力充沛的,強硬的
fickle=adj.(人)多變的
formidable=adj.優秀的,傑出的
graphic=adj.(敘述)生動的,栩栩如生的
grass-roots=adj.一般民眾的,草根性的
hilarious=adj.喧鬧的,極可笑的
hip=adj.內行的,時髦的
impromptu=adj.即興的,臨時起意的
invincible=adj.無敵的
lackluster=adj.乏善可陳的,平凡的
malign=adj.(影響)有害的,惡意的
maverick=adj.不合流俗的(人)
mercurial=adj.善變的
microscopic=adj.非常微小的
nascent=adj.初期的,剛開始的
nimble=adj.動作敏捷的
no-holds-barred=adj.為達到目的無所不用其極的
oblivious=adj.渾然不覺的
ostensible=adj.表面上的
palatable=adj.美味的；愉快的
paltry=adj.微不足道的
provisional=adj.臨時的,暫時的
replete=adj.充滿的
resilient=adj.韌性十足的
riveting=adj.有趣的,引人入勝的
runaway=adj.成長快速的,勢不可遏的
saturated=adj.飽和的
savvy=adj.精通的
seamless=adj.無接縫的,組合完美的
sinister=adj.邪惡的
sleek=adj.(人)時髦闊氣的
stark=adj.(對比)分明的
staunch=adj.堅定的
steadfast=adj.堅定不移的
torrential=adj.猛烈的,洶湧的
trailblazing=adj.開路先鋒的,創新大膽的
ubiquitous=adj.無所不在的
unfathomable=adj.深不可測的
unfettered=adj.不受拘束的
unscrupulous=adj.無道德原則的,不擇手段的
virtuoso=adj.大師級的,精湛的
voracious=adj.貪婪的
wayward=adj.不聽話的,任性的
whizzy=adj.快速的,出色的
wistful=adj.渴望的,企盼的
abide=v.忍受
abscond=v.(帶著錢等)潛逃
adapt=v.改編,改寫
annex=v.併吞
apprehend=v.逮捕
arrest=v.使停止,抑制
assail=v.攻擊
beef up=v.加強
bolster=v.增強
brandish=v.(得意地)揮舞
breach=v.突破,攻破
bristle=v.林立,豎立
brush aside=v.漠視,不理會(問題等)
chasten=v.懲罰,使變乖
chide=v.責罰
churn out=v.大量生產
click=v.發出「喀嗒」之聲
clobber=v.猛擊,痛擊
coincide=v.同時發生
confine=v.限定
consolidate=v.合併
contravene=v.觸犯
culminate=v.到達(極點)
dabble=v.涉獵,淺嘗
debilitate=v.使(人)衰弱
decry=v.非難,貶抑
deluge=v.使…大量湧至
despise=v.鄙視
dissemble=v.隱瞞,掩飾
diverge=v.分歧
diversify=v.使多樣化
don=v.穿上,戴上
dub=v.命名
elude=v.逃避
entertain=v.抱持(信念、感情)
entitle=v.使有資格,使有權利
epitomize=v.作為典範,代表
evaporate=v.蒸發,消失
extol=v.宣揚
flout=v.抗拒,違反
flush (out)=v.將…趕出隱藏處
foil=v.阻撓,使受挫折
garner=v.獲得,收穫
gobble (up)=v.大口猛吃,狼吞虎嚥
grab=v.急匆匆,胡亂地做某事
gridlock=v.交通堵塞
grill=v.盤問
huddle=v.擠成一團
hurtle=v.飛速前進
impede=v.阻止
indict=v.起訴
infringe=v.侵犯(法律)
inhibit=v.阻止,抑制
invoke=v.引用,求助於
jolt=v.劇烈搖晃,衝擊
languish=v.(在長久的困境中)受苦
leverage=v.使(事情)變容易
mimic=v.酷似,呈現…的形象
molest=v.騷擾,調戲
mushroom=v.快速增長,快速蔓延
negotiate=v.順利通過,成功越過
nibble=v.(小口)咬
nudge=v.輕推
override=v.使無效,推翻(決定)
peg=v.斷定
perch=v.使坐在…
precipitate=v.加速(壞事的來臨)
prescribe=v.開藥方,規定
pursue=v.走(路)
rankle=v.使憤慨,使痛苦
ravage=v.破壞,蹂躪
recede=v.後退
rehabilitate=v.平反,恢復
reiterate=v.重述,重申
relish=v.特別喜歡(做)
rendezvous=v.會面,約會
repeal=v.廢除(法律)
replenish=v.補充,補滿
revile=v.謾罵,痛斥
revitalize=v.再給予…活力,使復甦
rig=v.以不正當手法操縱(比賽選舉等)
scurry=v.急匆匆地走
shell out=v.付款
simulate=v.模仿,模擬
solicit=v.請求,徵求
spawn=v.(大量)生產,引起
spearhead=v.作…先鋒
stifle=v.壓制,遏制
synchronize=v.使…同步,使…一致
torpedo=v.破壞
tout=v.吹捧,吹噓
traverse=v.橫越
trudge=v.步履艱難地走
trumpet=v.大力宣傳
underscore=v.強調
unravel=v.散開,瓦解
usher in=v.預告,宣告…的到來
vilify=v.污衊,詆毀
vindicate=v.證明…為正確,合理
wink=v.眨眼,使眼色
advent=n.來臨,出現
animosity=n.敵意,仇恨
antecedent=n.前例,先聲
aura=n.氣氛,光暈
behemoth=n.龐然大物,組織龐大的機構
bulwark=n.防禦工事,堤防
bump=n.隆起部分,表困難
carnage=n.大屠殺
catalyst=n.觸媒,催化劑
censure=n.責難
charisma=n.群眾魅力
chic=n.流行
conglomerate=n.大型綜合企業
contingency=n.突發狀況
contraption=n.奇妙的設計
corridor=n.人口密集地帶
coup=n.大成功,大成就
dearth=n.缺乏
detractor=n.惡意批評者,毀謗者
dominion=n.支配
downsizing=n.公司裁員縮編
episode=n.插曲,事件
errand=n.差使,跑腿
ethnic group=n.少數民族
excursion=n.出遊,涉入
fad=n.一時的流行,時尚
feat=n.事蹟,成就
fold=n.控制範圍,原意為羊圈
forum=n.公開討論場所
fray=n.爭吵,爭論,騷動
gadget=n.精巧的小器械
gambit=n.手段,招式
geek=n.電腦狂,怪胎
glut=n.過量,供過於求
gorge=n.作嘔,厭惡
hacker=n.駭客,電腦程式專家
handler=n.處理者,經手人
haven=n.避難所
heretic=n.異端
holdout=n.拒不合作者,拒不參加者
hook-up=n.連線設施
iconoclast=n.反抗或破除傳統者
indignity=n.屈辱
insurgent=n.叛軍
interlocutor=n.對話者
juggernaut=n.可怕不可抗拒的力量
lever=n.手段,方法
minimalism=n.簡約主義
nausea=n.噁心,反胃
nostalgia=n.鄉愁,懷舊之情
novice=n.初學者,新手
omniscience=n.全知
outlay=n.費用,支出
paranoid=n.被迫害妄想症
pariah=n.被社會唾棄者
pestilence=n.瘟疫
pilgrimage=n.朝聖之旅,長途旅行
ploy=n.策略,手法
precursor=n.先驅,前輩;預兆,前兆
prowess=n.好本事,英勇
pundit=n.專家,權威
qualm=n.良心不安
rancor=n.怨恨,傷痛
rebuke=n.斥責,申誡
redoubt=n.避難所,庇護所
remnant=n.殘餘物
reprimand=n.斥責,申誡
rigor=n.折磨,嚴厲
scourge=n.天譴,災難
shackles=n.束縛
spin-off=n.副產品
swap=n.交換,互惠資金
tabloid=n.專報聳動新聞,配有大量圖片的小報
thrall=n.控制,奴役
traction=n.原為輪胎抓地力,引申為攻擊的把柄
trauma=n.創傷
twist=n.創新之舉,新發展
variant=n.變體,變種
venue=n.會場,地點
volatility=n.反覆無常,不穩定
write-off=n.(債務)勾銷
