<a>a</f><b>bandon</f>=<a>to put</f> + <b>power on</f> 被權利施壓<d>→</f> <d>音{一個笨蛋}</f> v.放棄
<b>ab</f><a>brevi</f><c>ate</f>=<b>to(ad-)</f> + <a>short</f> + <c>make</f> v.縮寫
<a>ab</f><b>norm</f>al=<a>away</f> + <b>rule</f> adj.不正常的
aboard=adv. prep.登機,登船
abolish=v.廢除
<a>ab</f><b>road</f>=<a>away</f> + <b>road</f> adj.國外的
<a>ab</f><b>rupt</f>=<a>off</f> + <b>break</f> adj.突然的
<a>ab</f><b>sent</f>=<a>away</f> + <b>feeling</f> 沒有出現<d>→</f> adj.缺席的
<a>ab</f><b>solu</f>te=<a>away</f> + <b>loose</f> adj.絕對的
<a>ab</f><b>sorb</f>=<a>away</f> + <b>suck</f> 吸收掉<d>→</f> v.吸收
<a>abs</f><b>tract</f>=<a>away</f> + <b>draw</f> 被拉開<d>->抽取</f> adj.抽象的
<a>ab</f><b>surd</f>=<a>away</f> + <b>deaf</f> adj.荒謬的
abundance=n.[U]豐富
<a>ab</f><b>use</f>=<a>away</f> + <b>use</f> 用壞<d>→</f> n.[U]濫用
<a>ac</f><b>celer</f>ate=<a>to</f> + <b>speed</f> v.加速
<a>ac</f><b>cent</f>=<a>to</f> + <b>to sing</f> n.腔調,口音
<a>ac</f><b>cept</f>=<a>to</f> + <b>to take</f> v.接受,同意
accessible=adj.可進入 可得的
accessory=n.[C]配件 adj.附屬的
<a>ac</f><b>cid</f>ent=<a>to</f> + <b>fall</f> n.[C]意外
<a>ac</f><b>claim</f>=<a>to</f> + <b>shout</f> n.(v.)歡呼
<a>ac</f><b>company</f>=<a>to</f> + <b>partner</f> v.陪伴
<a>ac</f><b>complish</f>=<a>to</f> + <b>finish</f> v.完成
<a>ac</f><b>count</f>=<a>to</f> + <b>count</f> n.帳號,理由
<a>ac</f><b>cumul</f>ate=<a>in addition</f> + <b>heap</f> v.累積
<a>ac</f><b>cur</f>ate=<a>to</f> + <b>take care</f> adj.正確的
<a>ac</f><b>cuse</f>=<a>against</f> + <b>reason</f> v.控告
<a>ac</f><b>custom</f>=<a>to</f> + <b>custom</f> v.習慣
<a>a</f><b>chiev</f>e=<a>to</f> + <b>chief</f> v.達成
acknowledge=v.承認,感謝
acquaint=v.熟悉
<a>ac</f><b>quire</f>=<a>extra</f> + <b>obtain</f> v.獲得
active=adj.積極的,主動的
actually=adv.實際上
<a>ad</f><b>apt</f>=<a>to</f> + <b>apt</f> 能力<d>→</f> v.適應
<a>ad</f><b>d</f>=<a>to</f> + <b>give</f> v.增加
<a>ad</f><b>dict</f>=<a>to</f> + <b>devoted</f> <d>音{愛得嗑它}</f> v.沉迷
additional=adj.額外的,多餘的
adequate=adj.足夠的
<a>ad</f><b>just</f>=<a>to</f> + <b>straight</f> 弄正確<d>→</f> v.調整
administrate=v.管理
<a>ad</f><b>mir</f>e=<a>to</f> + <b>wonder</f> <d>音{額的媽呀}</f> v.欽佩,欣賞
<a>admiss</f><c>ion</f>=<a>admit</f> + <c>action</f> n.[U](學校、俱樂部、會場)進入許可,入場費
<a>ad</f><b>mit</f>=<a>to</f> + <b>send</f> v.許可,承認
<a>ad</f><b>oles</f>cence=<a>to</f> + <b>nourish</f> n.青春期
<a>ad</f><b>vance</f>=<a>toward</f> + <b>front</f> v.前進 adj.預先的
advantage=n.[C,U]優勢
<b>ad</f><a>vent</f>ure=<b>toward</f> + <a>venture</f> n.[C,U]冒險
<a>ad</f><b>vers</f>e=<a>to</f> + <b>turn</f> adj.不利的
adversity=n.逆境
<b>ad</f><a>vert</f>ise=v.打廣告
<a>ad</f><b>vice</f>=<a>toward</f> + <b>vice</f> n.建議,忠告
<a>ad</f><b>voc</f>ate=v.擁護,提倡
<a>af</f><b>ford</f>=<a>to</f> + <b>forward</f> v.可負擔
afraid=adj.害怕的
<b>ag</f><a>gress</f>ive=<b>to</f> + <a>walk</f> adj.侵略的,侵犯的,挑釁的
<a>a</f><b>gree</f>=<a>to</f> + <b>pleasing</f> v.同意
<a>agri</f>culture=<a>field</f> n.[U]農業
aim=n.目的 v.瞄準
alcohol=<d>音{愛客喝}</f> n.[U]酒精
alert=adj.警覺的,留意的
alike=adj.相像的
allergic=adj.過敏的
allow=v.允許,許可
<a>alter</f>=<a>other</f> v.改變
alternative=n.[C]替代物 adj.替代的
<a>amat</f>eur=<a>taste for</f> n.[C]業餘 adj.不熟練的
amaze=v.驚訝
<a>ambi</f><b>ti</f>on=<a>around</f> + <b>to go</f> <d>音{俺必勝}</f> n.志向,抱負
amusement=n.娛樂,樂趣
analyze=<d>(同analyse)</f> v.分析
<a>an</f><b>cest</f>or=<a>before</f> + <b>to go</f> <d>音{an+ces先死+t的+or}</f> n.祖先
ancient=adj.古早的
<a>anni</f><b>vers</f><c>ary</f>=<a>year</f> + <b>to turn</f> + <c>place of</f> 每年改變一次<d>→</f> n.[C]週年紀念
<a>an</f><b>nounc</f>e=<a>to</f> + <b>proclaim</f> v.宣布,宣告
<a>an</f><b>noy</f>=<d>音{二奶疑}</f> <a>to</f> + <b>noise</f> v.煩擾,使生氣
<a>anti</f><b>cipate</f>=<a>before</f> + <b>to take</f> v.期望
anxiety=n.焦慮,擔心
anxious=adj.焦慮的,渴望的
<b>apo</f><a>log</f>ize=<b>away</f> + <a>speech</f> v.道歉
<a>apo</f><b>log</f>y=<a>away</f> + <b>speech</f> 退一步說 <d>音{兒扒了雞}</f> n.道歉
apparent=adj.明顯的
<a>ap</f><b>pear</f>=<a>to</f> + <b>show</f> v.出現,顯得
appearance=n.出現,外表
appetite=n.胃口
<a>ap</f><b>plaud</f>=<a>to</f> + <b>clap</f> v.鼓掌,讚美
<a>appli</f>cation=<a>apply</f> n.申請,應用
appointment=n.約會
<a>ap</f><b>preci</f>ate=<a>again</f> + <b>price</f> v.欣賞,感激
<a>ap</f><b>proach</f>=<a>to</f> + <b>near</f> v.接近,處理 n.方式,通道
<a>ap</f><b>propri</f>ate=<a>to</f> + <b>own</f> adj.合適的,適當的 v.撥給
approve=v.批准,贊成
approximately=adv.大約地
architecture=n.[C,U]建築物(風格）
argue=v.爭論
argument=n.爭論
arouse=v.喚起,喚醒
<a>ar</f><b>range</f>=<a>to</f> + <b>rank</f> v.安排
artificial=adj.人造的
as though=ph.好像
<a>a</f><b>scrib</f>e=<a>to</f> + <b>write</f> v.歸因於...
ashamed=adj.羞恥的
<b>a</f><a>spect</f>=<b>to</f> + <a>look</f> n.[C](事情、計畫等)方面
<b>a</f><a>spir</f>e=<b>to</f> + <a>breathe</f> v.渴望
<a>as</f><b>sembl</f>e=<a>again</f> + <b>together</f> v.集合,裝配
<a>asse</f>t=<a>enough</f> n.資產
<a>as</f><b>sign</f>=<a>again</f> + <b>sign</f> v.指派
<a>as</f><b>sist</f>=<a>toward</f> + <b>stand</f> 站過來<d>→</f> v.幫助
<a>as</f><b>soci</f>ate=<a>same</f> + <b>join</f> 結成團隊<d>→</f> v.聯想 n.夥伴
<b>as</f><a>sum</f>e=<b>to</f> + <a>take up</f> v.認為,假定
<a>as</f><b>sure</f>=<a>again</f> + <b>sure</f> 一再確定<d>→</f> v.確保
astonish=v.驚嚇
astound=v.驚訝
<a>astro</f><b>naut</f>=n.太空人
<a>athl</f>ete=n.運動員
atmosphere=n.氣氛
<a>at</f><b>tack</f>=<a>to</f> + <b>nail</f> v.(n.)攻擊
<b>at</f><a>tain</f>=<b>to</f> + <a>hold</f> v.達成
<a>at</f><b>tempt</f>=<a>to</f> + <b>try</f> v.嘗試
<a>at</f><b>tend</f>=<a>to</f> + <b>stretch</f> v.參加
attention=n.專心
<a>at</f><b>tit</f>ude=<a>to</f> + <b>tilt</f> n.[C]態度
<a>at</f><b>tract</f>=<a>to</f> + <b>pull</f> v.吸引
<a>at</f><b>trib</f>ute=<a>to</f> + <b>bestow</f> v.歸因於
<a>audi</f>ence=<a>to hear</f> <d>音{我的恩師}</f> n.[C]聽眾
author=n.[C]作家,作者
authority=n.權利,權威
<a>auto</f><b>mat</f>ic=<a>self</f> + <b>willing</f> adj.自動的
available=adj.可獲得的,可達到的
average=n.[C,U]平均數,一般水平 adj.平均的
<a>a</f><b>void</f>=<a>out</f> + <b>empty</f> v.避免
<a>a</f><b>wake</f>=<a>on</f> + <b>wake</f> adj.醒著的
award=n.[C]獎勵
aware=adj.知道的
awesome=adj.可怕的,極棒的
awful=adj.可怕的
awkward=adj.笨拙的
background=n.[C,U]背景
bacteria=n.[C]細菌
balance=<d>音{揹冷屍}</f> n.[C,U]平衡,均衡,協調
ban=v.禁止
<b>bank</f><a>rupt</f>=<b>bank</f> + <a>break</f> adj.破產的
barely=adv.幾乎不
bargain=n.[C]便宜貨 v.議價
barrier=n.[C]障礙
basic=adj.基本的,基礎的
battle=n.戰鬥
bear=v.忍受 n.熊
beg=v.乞求
behave=v.行為
behavior=n.[U]行為
behind=prep.在…之後
bend=v.彎曲
<a>bene</f><b>fic</f>ial=<a>good</f> + <b>make</f> adj.有益的
beyond=prep.超越
<a>bio</f><b>graph</f>y=<a>life</f> + <b>to write</f> n.自傳
blame=v.責備,指責,歸咎 n.過失,責備
blend=n.[C]混合,調和
bless=v.恩賜
blossom=v.開花,繁盛
boast=v.誇大
<a>bon</f><b>us</f>=<a>good</f> + <b>thing</f> n.好處,紅利
bounce=v.彈跳
brand=n.品牌
brave=adj.勇敢的
bravery=n.勇敢
breathe=v.呼吸
breathtaking=adj.令人屏息的
bribe=n.(v.)賄賂
bright=adj.明亮的
brilliant=adj.聰明的,燦爛的
broaden=v.拓寬
broke=adj.破產的
browse=v.瀏覽
brutal=adj.殘酷的
budget=n.[C]預算 v.(編)預算
burden=n.[C]負擔
burglar=n.竊賊
bury=v.埋
calculate=v.計算
campaign=n.[C]活動 v.活動
candidate=n.[C]候選人
<a>cap</f><b>able</f>=<a>take</f> + <b>ability</f> adj.有能力做…的,能夠(做)…的
<a>cap</f><b>acity</f>=<b>ability</f> + <a>to take</f> n.能力,容量
<a>capit</f>al=<a>head</f> n.[C]首都
<a>cap</f>ture=<a>take</f> v.捕捉 n.戰利品
care=<d>音{開}</f> n.注意,小心 v.關心
career=n.[C]生涯,職業
carry=<d>音{開累}</f> v.運送,攜帶
carve=v.雕刻
cast=n.(v.)投擲
casual=adj.隨意的
casualty=n.傷亡
cause=n.原因,理由,事業
cautious=adj.謹慎的
cease=v.停止
celebrate=v.慶祝
celebrated=adj.著名的
celebrity=n.[C]名人
ceremony=n.典禮
certain=adj.確定,某些
<a>certifi</f>cate=<a>certify</f> n.證明
challenge=v.(n.)挑戰
championship=n.[C]冠軍
chaos=<d>音{吵死}</f> n.混亂
character=n.角色,性格
characteristic=n.[C]特色,特徵
charge=v.收費,充電,控告,負責
charity=n.[C]慈善
charming=adj.迷人的,嬌媚的
chat=v.閒談
cheerful=adj.開心的
chemical=adj.化學的　n.化學藥品
cherish=v.珍惜
choice=n.選擇
chore=n.[C]家務,雜事
<a>chron</f>ic=<a>time</f> adj.長期的
<a>circu</f><b>late</f>=<a>around</f> + <b>to move</f> 繞圈走<d>→</f> v.循環,流通
<a>circum</f><b>st</f><c>ance</f>=<a>around</f> + <b>to stand</f> + <c>of state</f> n.[C]環境
citizen=n.公民,市民
civilization=n.[C]文明
claim=n.(v.)宣稱
<b>clari</f><a>fy</f>=<b>clear</f> + <a>to make</f> v.澄清
client=n.[C]顧客
climate=n.氣候
closely=adv.緊密地
<b>clums</f><a>y</f>=<b>benumb</f> + <a>full of</f> adj.笨拙的
code=n.[C]密碼,法規 v.編碼
coincidence=n.巧合
<a>col</f><b>lapse</f>=<a>together</f> + <b>fall</f> v.倒塌
<a>col</f><b>league</f>=<a>with</f> + <b>choose</f> n.[C]同事,同盟
<a>col</f><b>lect</f>=<a>together</f> + <b>gather</f> v.收集
colony=n.[C]殖民地
<a>com</f><b>bin</f>e=<a>together</f> + <b>two</f> v.結合
comedy=n.喜劇
<b>com</f><a>fort</f>=v.(n.)安慰 n. 舒適
<a>com</f><b>mand</f>=v.命令,造詣
<a>com</f><b>ment</f>=<a>together</f> + <b>result</f> (v.)n.[C]評論
commercial=adj.商業的 n.廣告
commitment=n.承諾
committee=n.委員會
common=adj.共同的,普通的
<a>com</f><b>munic</f>ate=<a>together</f> + <b>task</f> v.溝通
community=n.[C]社區,社會
<a>com</f><b>mute</f>=<a>together</f> + <b>change</f> v.通勤
company=n.公司,同伴 v.陪伴
compare=v.比較
<a>com</f><b>pel</f>=<a>together</f> + <b>push</f> v.強迫
<a>com</f><b>pens</f>ate=<a>with</f> + <b>weigh</f> v.補償
competence=n.能力
competent=adj.有能力的
competition=n.[C,U]競爭
complaint=n.[C,U]抱怨,抗議
<a>com</f><b>plete</f>=<a>together</f> + <b>fill</f> v.完成,完整
<a>com</f><b>plex</f>=<a>with</f> + <b>weave</f> adj.複雜的
complicated=adj.複雜的
compliment=n.(v.)讚美
<b>com</f><a>pose</f>=<b>together</f> + <a>place</f> v.作曲,組成
<a>com</f><b>prehend</f>=<a>completely</f> + <b>seize</f> v.領悟,了解
<a>com</f><b>press</f>=<a>together</f> + <b>push</f> v.壓縮
compromise=n.(v.)妥協,折衷
conceal=v.密封,隱蔽
<a>con</f><b>centr</f>ate=<a>together</f> + <b>center</f> v.集中,聚集
<a>con</f><b>cept</f>=<a>together</f> + <b>take in</f> n.[C]概念,觀念
<a>con</f><b>cern</f>=<a>with</f> + <b>perceive</f> v.關心,擔心
concert=n.[C]音樂會 v.一致
<a>con</f><b>cise</f>=<a>all</f> + <b>cut</f> adj.簡明的
<b>con</f><a>clud</f>e=<b>all</f> + <a>close</f> 全部關掉<d>→</f> v.結論
<a>con</f><b>crete</f>=<a>together</f> + <b>grow</f> adj.具體的
condition=n.[C]情況,條件
<b>con</f><a>duct</f>=<b>together</f> + <a>to lead</f> v.指揮 n.行為
conference=n.[C]會議
confess=v.承認
<b>con</f><a>fid</f>ent=<b>full</f> + <a>trust</f> adj.有信心的,自信的
<a>con</f><b>fid</f>ential=adj.秘密的
<a>con</f><b>fin</f>e=<a>with</f> + <b>bound</f> v.限制,禁閉 n.界限,邊界
<a>con</f><b>firm</f>=<a>together</f> + <b>firm堅定</f> v.確認
<b>con</f><a>form</f>=<b>together</f> + <a>shape</f> 形式共同<d>→</f> v.遵守
confuse=v.使困惑,把…弄糊塗
connect=v.連接
conscious=adj.有意識的
<b>con</f><a>sequ</f>ence=<b>together</f> + <a>follow</f> n.[C]結果,後果
conservative=adj.保守的
conserve=v.保育,保存
consider=<d>音{坑誰的}</f> v.考慮,認為
considerate=adj.體貼的
console=v.慰問
<a>con</f><b>sta</f>nt=<a>together</f> + <b>stand</f> adj.持續的
<b>con</f><a>struct</f>=<b>together</f> + <a>build</f> v.建設
consult=v.請教,查閱
<b>con</f><a>sum</f>e=<b>together</f> + <a>take</f> v.消耗,消費
<a>con</f><b>tact</f>=<a>associate</f> + <b>touch</f> n.(v.)接觸,聯繫
<b>con</f><a>tain</f>=<b>together</f> + <a>hold</f> v.包含
container=n.[C]容器
<a>con</f><b>tempor</f><c>ary</f>=<a>together</f> + <b>time</f> + <c>of</f> adj.同期的,現代的
content=n.[C,U]內容  v. (adj.)滿意(的)
<a>con</f><b>test</f>=<a>together</f> + <b>witness</f> n.[C]比賽,競爭 v.爭論,爭辯
contract=n.[C]契約,合同
<a>contra</f><b>st</f>=<a>against</f> + <b>to stand</f> n.[U]對比
<a>con</f><b>trib</f>ute=<a>together</f> + <b>bestow</f> v.貢獻,造成
<a>contro</f><b>vers</f>y=<a>against</f> + <b>to turn</f> n.爭議
conventional=adj.慣例的
converse=n.(adj.)相反(的) v.交談
conversely=adv.相反地
<a>con</f><b>vey</f>=<a>together</f> + <b>way</f> v.傳遞
<a>con</f><b>vinc</f>e=<a>overcome</f> + <b>conquer</f> v.說服
<a>cor</f><b>rupt</f>=<a>much</f> + <b>break</f> adj.腐敗的
costly=adj.昂貴的
courteous=adj.有禮貌的
<a>court</f>esy=<a>heart</f> n.禮節
crash=v.(n.)撞毀
craze=n.狂熱,風潮
create=v.創造
<a>cred</f>ible=<a>to believe</f> adj.可信的
<a>cred</f><b>ulous</f>=<a>to believe</f> + <b>easily</f> adj.輕信的
<b>crimin</f><a>al</f>=<b>crimi</f> + <a>person of</f> n.罪犯 adj.犯罪的
crisis=n.危機
critical=adj.批評的,關鍵的
criticize=v.批評,評論,挑剔
crop=n.農作物
crowd=n.群眾 v.塞滿
cruel=adj.殘酷的
cultivate=v.培養
cultural=adj.文化的
cure=v.(n.)治療
curious=adj.好奇的
curl=adj.彎曲的
<a>cur</f>rent=<a>run</f> 跑的<d>→</f> adj.目前的 n.流動
curse=n.(v.)詛咒
custom=n.習慣
damage=v.(n.)損害,破壞
<a>de</f><b>bt</f>=<a>away</f> + <b>have</f> n.債,債務
<a>dec</f><b>ade</f>=<a>ten</f> + <b>action</f> n.[C]十年
decay=v.(n.)破壞
<a>de</f><b>ceiv</f>e=<a>from</f> + <b>take</f> v.欺騙
decent=adj.體面的
declare=v.宣佈
<a>de</f><b>cline</f>=<a>from</f> + <b>bend</f> (v.)n.[U]下降 v.拒絕
decorate=v.裝潢
deed=<d>音{地的}</f> n.行為
defeat=v.打敗,失敗
<a>de</f><b>fect</f>=<a>down</f> + <b>to do</f> n.缺失
<a>de</f><b>fend</f>=<a>away</f> + <b>strike</f> v.保護,防禦
deficient=adj.不足的
<b>de</f><a>fin</f>e=<b>down</f> + <a>bound</f> v.下定義
definite=adj.明確的
definition=n.[C,U]意義
degree=n.程度
deject=v.沮喪
<b>de</f><a>leg</f>ate=<b>from</f> + <a>law</f> v.指派,派遣
<a>de</f><b>lete</f>=<a>away</f> + <b>wipe</f> v.刪除
delicate=adj.細緻的,脆弱的
delight=v.使高興,使欣喜 n.快樂
<a>de</f><b>liver</f>=<a>make</f> + <b>free</f> v.遞送
<a>de</f><b>mand</f>=<a>completely</f> + <b>order</f> n.[U]需要,需求 v.要求,查詢
demanding=adj.嚴苛的
<a>de</f><b>monstr</f>ate=v.示範
<a>de</f><b>ny</f>=<a>away</f> + <b>refuse</f> v.否認,拒絕
depart=v.出發,離開
<b>de</f><a>pend</f>ent=<b>down</f> + <a>to hang</f> adj.依賴的
<a>de</f><b>pop</f>ulation=<a>down</f> + <b>people</f> n.人口減少
<a>de</f><b>posit</f>=<a>down</f> + <b>posit</f> v.存款
<a>de</f><b>press</f>=<a>down</f> + <b>push</f> v.沮喪
deprive=v.剝奪
<b>de</f><a>scrib</f>e=<b>down</f> + <a>to write</f> 描寫
<a>de</f><b>sert</f>=<a>undo</f> + <b>in row</f> n.沙漠 v.遺棄
<a>de</f><b>serve</f>=<a>completely</f> + <b>serve</f> v.應得
<a>de</f><b>sign</f>=<a>down</f> + <b>to mark</f> n.(v.)設計
despair=n.(v.)[U]絕望
desperate=adj.渴望的,絕望的
<a>de</f><b>spise</f>=<a>down</f> + <b>look</f> v.鄙視
despite=prep.雖然,僅管
destination=n.[C]目的地
destroy=v.破壞
destructive=adj.破壞的
detail=n.細節 v.詳述,派遣
detect=v.偵察
<a>de</f><b>termine</f>=<a>off</f> + <b>end</f> v.決定,下定心
determined=adj.有決心的
<a>de</f><b>test</f>=<a>down</f> + <b>witness</f> v.討厭
develop=v.發展
device=n.[C]裝置
devise=v.發明
devote=v.奉獻,投入
<b>dia</f><a>gnos</f>e=<b>through</f> + <a>know</f> v.診斷
dignity=n.[U]尊嚴
diligent=adj.勤勉的,勤奮的
diminish=v.(使)減少
<a>di</f><b>rect</f>=<a>way</f> + <b>straight</f> v.指揮,直接
direction=n.方向
<a>dis</f><b>agree</f>=<a>not</f> + <b>agree</f> v.不同意
<b>dis</f><a>aster</f>=<b>away</f> + <a>star</f> 星位不正<d>→</f> 表示有災難<d>→</f> n.[C,U]災難
discipline=n.[U]紀律
<b>dis</f><a>clos</f>e=<b>not</f> + <a>close</f> 把關的打開<d>→</f> v.揭發,洩露
discount=n.[C,U]折扣
discover=v.發現
discuss=v.討論
disease=n.疾病
disgust=n.(v.)作噁
<a>dis</f><b>miss</f>=<a>apart</f> + <b>send</f> v.解散
disobey=v.違背
<a>dis</f><b>put</f>e=<a>not</f> + <b>think</f> n.[C,U]爭執,爭論 v.辯論,懷疑
<b>dis</f><a>rupt</f>=<b>away</f> + <a>break</f> v.中斷,混亂
<a>dis</f><b>suade</f>=<a>against</f> + <b>urge</f> v.勸阻
distant=adj.遙遠的
distinct=adj.(清楚)明顯的
distinguish=v.區分
distinguished=adj.傑出的
<a>dis</f><b>tract</f>=<a>away</f> + <b>pull</f> v.分心
distress=n.苦惱　
<a>dis</f><b>trib</f>ute=<a>away</f> + <b>bestow</f> v.分配
district=n.區域
disturb=v.擾亂
diverse=adj.不同的
divide=v.分開
document=n.[C]文件
domestic=adj.國內的,本土的,(家庭的)
<a>domin</f><c>ate</f>=<a>lord</f> + <c>make</f> v.支配,控制
donate=v.捐贈
<a>dou</f><b>bt</f>=<a>two</f> + <b>state</f> 二種狀態<d>→</f> v.懷疑
dramatic=adj.戲劇性的
draw=v.抽取，畫
dread=v.害怕
drop=n.滴,下降
drug=<d>音{抓個}</f> n.藥物
due=<d>音{丢}</f> adj.到期的
<a>dur</f>able=adj. 耐用的
dwell=v.居住
<a>dynam</f>ic=<a>power</f> adj.有活力的
eager=adj.急切的
earnest=adj.誠摯的
earthquake=n.地震
ease=n.減輕
economical=adj.節約的,經濟的
edit=v.編輯
<b>e</f><a>duc</f><c>ate</f>=<b>out</f> + <a>lead</f> + <c>make</f> 引出知識<d>→</f> v.教育
<a>ef</f><b>fect</f>=<a>out</f> + <b>to do</f> n.後果,效力;v.導致
efficient=adj.有效率的
<a>ef</f><b>fort</f>=<a>out</f> + <b>strong</f> n.努力
either=adj.二者之一
<a>e</f><b>labor</f>ate=<a>very</f> + <b>work</f> adj.精心的 v.精心製作
elastic=adj.有彈性的
<a>e</f><b>lect</f>=<a>out</f> + <b>pick</f> v.選舉
elegant=adj.文雅的
element=n.元素
elementary=adj. 基本的
eligible=adj.有資格的
eliminate=v.消除
embarrass=v.尷尬
emergency=<d>音{已沒氣息}</f> n.[C,U]緊急的
emotion=n.情感
emotional=adj.情緒化的
emphasize=v.強調
employ=v.雇用,錄用 n.雇用
<a>en</f><b>able</f>=<a>make</f> + <b>able</f> v.使其能夠
<a>en</f><b>counter</f>=<a>in</f> + <b>opposite</f> n.遭遇
<a>en</f><b>cour</f><c>age</f>=v.鼓勵
<a>en</f><b>danger</f>=<a>make</f> + <b>danger</f> v.瀕臨危險
endure=v.忍耐
enemy=n.敵人
<b>en</f><a>erg</f>y=<b>in</f> + <a>energy</f> 進入能量<d>→</f> n.能量,活力
<a>en</f><b>forc</f>e=<a>with</f> + <b>strong</f> v.強迫,實施
engaged=adj.忙於,已訂婚
engineer=n.[C]工程師
enhance=v.加強
<a>en</f><b>large</f>=<a>make</f> + <b>big</f> v.擴大
enormous=adj.巨大的
ensure=v.確保
entertain=v.招待,使歡樂
enthusiastic=adj.熱誠的
entire=adj.完全的
entrance=n.進入,入口
envious=adj.忌妒的
environment=n.環境
<b>epi</f><a>dem</f>ic=<b>upon</f> + <a> people</f> adj.流行的
equal=adj.相等的
equipment=n.[U]設備
<a>e</f><b>rase</f>=<a>out</f> + <b>scrape</f> v.消除
error=n.錯誤
<a>es</f><b>cape</f>=<a>out</f> + <b>cape</f> v.逃離
essential=adj.必要的,不可缺的 n.本質,實質,要素,要點
establish=v.建立,創辦
esteem=n.[U]尊敬 v.尊敬
estimate=v.估計
eternal=adj.永遠的
<a>e</f><b>valu</f>ate=<a>out</f> + <b>worth</f> v.評估
eventually=adv.最後地
evidence=n.[U]證據
<b>e</f><a>volv</f>e=<b>out</f> + <a>roll</f> v.發展,展開
<a>ex</f><b>act</f>=<a>out</f> + <b>lead</f> adj.精確的
exactly=adv.確切地,正是
examine=v.檢驗
<a>ex</f><b>ceed</f>=<a>out</f> + <b>to go</f> v.超過
exception=n.例外
excessive=adj.過量的
<b>ex</f><a>clus</f>ive=adj.專有的,獨有的
execute=v.執行
exist=v.存在
<a>ex</f><b>pand</f>=<a>out</f> + <b>spread</f> v.擴展
<b>ex</f><a>pens</f>e=<b>out</f> + <a>to pay</f> n.[C]支出
experience=n.(v.)經歷,體驗
expert=n.專家 adj.精通的
explain=v.解釋
explore=v.探測
<a>ex</f><b>pose</f>=<a>out</f> + <b>place</f> v.暴露,接觸到,揭露
<a>ex</f><b>tend</f>=<a>out</f> + <b>stretch</f> v.延長
extent=n.[U]程度
extinct=adj.滅絕的
extinguish=v.消滅
extra=adj.額外的,多餘的
<a>extra</f><b>ordinary</f>=<a>out</f> + <b>ordinary</f> adj.非凡的
extremely=adv.極其,非常
fable=n.[C]寓言故事
fabulous=adj.極好的
<a>faci</f>litate=<a>render easy</f> v.幫助
facility=n.[C,U]設施,技能
factor=n.[C]因素,要素,原因
fail=v.失敗(未能)
fairly=adv.公平地,相當
faith=n.[U]信念,相信
familiar=adj.熟悉的
<b>fam</f><a>ous</f>=<a>having</f> + <b>fame</f> adj.有名的
fancy=<d>音{粉絲}</f> adj.豪華的,精美的
fantasy=n.幻想
far-reaching=adj.(影響)深遠的
fare=n.費用
fascinate=v.吸引
fatal=adj.致命的
fate=n.命運
fatigue=n.(v.)疲憊
fault=n.過錯,缺點,故障,毛病 v.挑剔,弄錯
favor=n.(v.)偏好 n.恩惠
favorable=adj.有利的
favorite=adj. 喜歡的
feature=n.[C]特色
fertile=<d>音{分他哟}</f> adj.肥沃的
fever=n.發燒,狂熱
financial=adj.財政的
fit=adj.適合的,健康的
fix=v.固定,修理
flatter=v.奉承
<a>flex</f>ible=<a>bend</f> adj.有彈性的
flu=n.感冒
fond=adj.喜愛的
forbid=v.禁止
<a>forc</f>e=v.強迫  n.力量
<a>fore</f><b>cast</f>=<a>before</f> + <b>cast</f> n.(v.)預測
foreign=adj.外國的,陌生的
forgive=v.原諒
form=n.形狀,類型,表格
<a>form</f>al=<a>shape</f> adj.正式的
former=adj.從前的,前者的 pron.前者
<a>fort</f><b>une</f>=<a>luck</f> + <b>carry</f> n.[C,U]財富,運氣
found=v.建立
foundation=n.[U]基礎,基金會
frankly=adv.坦白地
frequent=adj.經常的
frustrate=v.挫折
fuel=n.[C,U]燃料
fulfill=v.完成(任務等),實現(願望等)
function=n.功能,作用
fundamental=adj.基礎的
furious=adj.暴怒的
further=adv.進一步地 adj.更進一步的
gain=v.獲得
gather=v.聚集,收集,採集
gathering=n.集會
gender=n.[C]性別
<a>gen</f>erate=<a>produce</f> v.產生
generous=adj.慷慨的,大方的,有雅量的
genetic=adj.遺傳的
genuine=adj.真正的,真誠的
gift=<d>音{給付他}</f> n.禮品,天賦
global=adj.全球的
glow=v.閃耀
goal=n.目標
grab=v.抓
grace=n.優雅
gradually=adv.逐漸地
grant=v.給予,准予
<a>grate</f>ful=<a>pleasing</f> adj.感謝的
<a>grati</f><b>tude</f>=<a>thanks</f> + <b>attitude</f> n.[U]感激
greedy=adj.貪心的
grieve=v.(使)悲痛,(使)傷心,憂傷
guest=n.客人
guilty=n.[C]有罪的
<a>habit</f>=n.習慣
hardly=adv.幾乎不
harmful=adj.有害的
harvest=vt.收成,收穫
hazard=n.(v.)冒險,危險
heal=v.治癒
hesitate=v.遲疑
hide=v.隱藏
historic=adj.有歷史意義的
hold=v.握住,認為
hollow=adj.空的 v.挖空 n.洞
honest=adj.誠實的
hospitable=adj.好客的,友善的
host=v.主辦 n.主人
<b>host</f><a>ile</f>=<b>host</f> + <a>likely to be</f> adj.有敵意的
huge=adj.龐大的,巨大的
humiliate=v.羞辱
humor=<d>音{幽默}</f> n.幽默
ignore=v.忽略
<a>il</f><b>leg</f>al=<a>not</f> + <b>law</f> 非法的
<a>il</f><b>liberal</f>=<a>not</f> + <b>liberal</f> adj.自由開放的
<b>il</f><a>lumin</f>ate=v.照亮
<a>il</f><b>lustr</f><c>ate</f>=<a>in</f> + <b>bright</f> + <c>make</f> v.圖解(示)
image=n.[C]形象,印象
imitate=v.模仿
<a>im</f><b>media</f>te=<a>not</f> + <b>halve</f> adj.直接的,立刻的
impact=n.[U]衝擊,撞擊 v.擠入,撞擊,影響
<a>im</f><b>pair</f>=<a>in</f> + <b>worse</f> v.傷害
impartial=adj.公正的
imply=v.暗指,暗示
<b>im</f><a>pose</f>=<b>into</f> + <a>place</f> v.強加...於..
impression=n.[C,U]印象
improve=v.改善
<b>in</f><a>cid</f>ent=<b>upon</f> + <a>fall</f> n.[C]事件
<b>in</f><a>clud</f>e=v.包含
income=n.收入
<a>in</f><b>crease</f>=<a>in</f> + <b>grow</f> v.n.增加
<b>in</f><a>cred</f>ible=<b>not</f> + <a>to believe</f> adj.難以置信的
<b>in</f><a>dic</f><c>ate</f>=<b>none</f> + <a>to speak</f> + <c>make</f> v.指示,暗示
<a>in</f><b>differ</f>ent=<a>not</f> + <b>apart</f> 不是同也不是不同<d>→</f> adj.冷漠的
indispensable=adj.不可或缺的
individual=adj.個別的
indulge=v.沉迷
industrious=adj.勤勞的,勤奮的
inevitable=adj.不可避免的
infamous=adj.名聲不好的
<a>in</f><b>fant</f>=<a>not</f> + <b>speak</f> <d>音{嬰煩他}</f> n.[C]嬰兒
<a>in</f><b>fect</f>=<a>in</f> + <b>perform</f> v.感染,傳染
inferior=adj.較差的
infirm=adj.虛弱的
<b>in</f><a>flu</f>ence=<b>into</f> + <a>flow</f> 流入<d>→</f> n.影響
<b>in</f><a>form</f>=<b>in</f> + <a>shape</f> 進入形式<d>→</f> v.通知
<a>in</f><b>habit</f>=<a>in</f> + <b>dwell</f> v.居住於
initiate=v.開始
injure=v.傷害
innocent=adj.天真的,無辜的
innovative=adj.創新的
<a>in</f><b>scrib</f>e=<a>in</f> + <b>write</f> v.刻
insignificant=adj.重要顯著的
<a>in</f><b>spect</f>=<a>into</f> + <b>look</f> v.調查,(檢查)
<b>in</f><a>spir</f>e=<b>in</f> + <a>breathe</f> v.激發
<a>in</f><b>sta</f>nt=<a>in</f> + <b>stand</f> adj.即刻的
<a>in</f><b>stin</f>ct=<a>on</f> + <b>prick</f> n.[C,U]直覺 adj.直覺的
institution=n.機構
<a>in</f><b>struct</f>=<a>on</f> + <b>build</f> v.指示
instrument=n.手段,器具
<a>in</f><b>sult</f>=<a>on</f> + <b>leap</f> (v.) adj.侮辱
insure=v.保險
intelligent=adj.聰明的
<a>in</f><b>tend</f>=<a>toward</f> + <b>stretch</f> v.打算
intense=adj.強烈的
<b>intensi</f><a>fy</f>=<b>intend</f> + <a>to make</f> v.加強
intensive=adj.集中的,加強的
<a>inter</f><b>act</f>=<a>between</f> + <b>act</f> n.互動
interaction=n.[C]互動
<b>inter</f><a>fer</f>e=<b>between</f> + <a>strike</f> v.干涉
<a>inter</f><b>nation</f>al=<a>between</f> + <b>nation</f> adj.國際的
interpret=v.闡述
intimate=adj.親密的
<a>in</f><b>tuit</f>ion=<a>not</f> + <b>protect</f> n.直覺
invade=v.入侵
<b>in</f><a>vent</f>=<b>in</f> + <a>come</f> v.發明
<a>in</f><b>vest</f>=<a>in</f> + <b>clothe</f> v.投資
investigate=v.調查
<a>in</f><b>volv</f>e=<a>in</f> + <b>roll</f> v.牽連
irony=<d>音{愛惹你}</f> n.諷刺
irritate=v.惱怒
isolate=v.隔離,孤立 n.隔離種群
issue=n.議題 v.發佈
jealous=adj.忌妒的
journey=n.[C]旅行,航程
just=adv.僅僅,剛剛 adj.公正的
justice=n.[U] 正義,(公平,公正)
knock=v.敲,擊倒
label=n.[C]標籤
lack=v.n.缺少
landscape=n.[C,U]景色,風景,山水畫
latest=n.最新的
lay=v.放置,下蛋
lease=n.(v.)租賃
leisure=adj.空閒的  n.休閒
lend=v.借出
lighten=v.使變亮,使光明,放鬆
likely=adj.可能的 adv.很可能
limit=v.限制
link=v.連結
literally=adv.字面上
local=adj.當地的
<a>loc</f>ation=<a>place</f> n.[C]位置
loose=adj.寬鬆的
lower=v.降低,減弱
luxury=n.[C,U]奢侈
magnetic=adj.有吸引力的
<a>magni</f><c>fic</f>ent=<a>great</f> + <c>make</f> adj.壯麗的
<a>magni</f><c>fy</f>=<a>great</f> + <c>to make into</f> v.放大
<b>main</f><a>tain</f>=<b>hand</f> + <a>hold</f> v.維持
majestic=adj.壯麗的
manipulate=v.操控
manners=n.禮貌,態度
<b>manu</f><a>fact</f>ure=<b>hand</f> + <a>make</f> n.[U]製造業,製造
marvelous=adj.神奇的
material=n.材料,資料,原料
mature=adj.成熟的
mean=adj.卑鄙的
meanwhile=adj.同時的
measure=n.尺寸,量具,措施
melt=v.融化,熔化,溶解,熔解
<a>mem</f><c>ory</f>=<a>remember</f> + <c>process</f> n.記憶
mental=adj.心理的
mention=vt.提及;提到
merchant=n.商人
message=n.信息
mind=n.心理
miraculous=adj.奇蹟的
mission=n.任務
moderate=adj.適當的
modesty=n.謙虛
mood=n.[C]心情,情境,情緒
moral=adj.道德的
<a>mort</f>al=<a>death</f> adj.會死的
motivate=v.激發
multiple=adj.多的
mutual=n.[C]互相的
<b>mysteri</f><a>ous</f>=<a>having</f> + <b>mystery</f> adj.神秘的
<a>nat</f>ive=<a>born</f> adj.本地的
neat=adj.整潔的
necessary=adj.必需的
negative=adj.否定的,消極的
<a>neg</f><b>lect</f>=<a>not</f> + <b>select</f> v.忽略
negotiate=v.協商
noble=adj.高貴的
normal=adj.正常的
notable=adj.顯著的
notice=n.注意
notorious=adj.名聲不好的
novel=adj.新奇的 n.小說
<a>numer</f>ous=<a>number</f> adj.多數的
nutrition=n.營養
<b>ob</f><a>ject</f>=<b>against</f> + <a>throw</f> v.反對 n.物體,目標
observe=v.觀察,遵守
<a>ob</f><b>stacle</f>=<a>against</f> + <b>to stand</f> n.[C]障礙
<a>ob</f><b>struct</f>=<a>by</f> + <b>build</f> v.阻礙
obvious=adj.明顯的
occasion=n.[C]場合
<a>oc</f><b>cur</f>=<a>toward</f> + <b>run</f> v.發生
offense=n.冒犯
<a>of</f><b>fer</f>=<a>against</f> + <b>carry</f> v.n.提供
official=n.官員 adj.官方的
opportunity=n.[C,U]機會
optimistic=adj.樂觀的
option=n.選擇
order=n.訂單,次序 n.(v.)命令,訂購
ordinary=adj.普通的,平凡的
organization=n.組織
<b>organ</f><a>ize</f>=<a>make</f> + <b>organ</f> n.安排
originate=v.起源
orphan=n.孤兒
outcome=n.[C]結果
outstanding=adj.傑出的
overcome=v.克服
owe=v.欠,歸因於
pace=n.[C,U]步調
package=n.包裹 v.打包
pain=n.(v.)痛苦
paradise=n.[U]天堂
paralyze=v.癱瘓,麻痹
pardon=n.(v.)原諒
participate=v.參加
particular=adj.特別的
passenger=n.旅客,乘客
passion=n.熱情
passive=adj.被動的
<b>pass</f><a>port</f>=<b>pass</f> + <a>to carry</f> n.護照
pathetic=adj.可悲的,可憐的
patient=adj.耐心的 n.病人
pattern=n.形式
<a>per</f><b>ceiv</f>e=<a>through</f> + <b>take</f> v.察覺
<a>per</f><b>manent</f>=adj.永遠的
<b>per</f><a>mit</f>=<b>through</f> + <a>send</f> v.允許
perpetual=adj.永久的
<a>per</f><b>plex</f>=<a>through</f> + <b>entangled</f> v.困惑
<a>per</f><b>sist</f>=<a>through</f> + <b>stand</f> v.堅持
<a>per</f><b>spect</f>ive=<a>through</f> + <b>to look</f> n.觀點
<a>per</f><b>suade</f>=<a>through</f> + <b>to urge</f> v.說服
pessimistic=adj.悲觀的
phenomenon=n.[C]現象
physical=adj.身體的
pity=n.[U]可惜,可憐
pleasant=adj.愉悅的
please=v.取悅
plentiful=adj.豐富的
<a>poli</f>cy=<a>city</f> 政策
polite=adj.有禮貌的
pollute=v.污染
pollution=n.[U]汙染
<a>pop</f>ular=adj.普遍的,流行的
portrait=n.肖像,人像
<a>pos</f>ition=<a>place</f> n.職位,位置
positive=adj.正面的,積極的
<a>posse</f>ss=<a>power</f> v.擁有
<a>poss</f>ible=<a>power</f> adj.可能的
<a>post</f><b>pon</f>e=<a>after</f> + <b>to put</f> v.延遲
<a>poten</f>tial=<a>power</f> adj.潛在的 n.潛力
poverty=n.[U]貧窮
practical=adj.實際的
practice=n.練習,實施
praise=n.贊美
precaution=n.預防
precious=adj.珍貴的
<b>pre</f><a>cise</f>=<b>before</f> + <a>cut</f> 預先切好<d>→</f> adj.精確的
<a>pre</f><b>judice</f>=<a>before</f> + <b>judge</f> n.偏見
<a>pre</f><b>pare</f>=<a>before</f> + <b>pare</f> v.凖備
<a>pre</f><b>scrib</f>e=<a>before</f> + <b>write</f> v.開藥方
<b>pre</f><a>scrip</f>tion=<b>before</f> + <a>to write</f> n.[C]藥方
present=adj.出席的 n.現在
preservation=n.保留,預約
<a>pre</f><b>serve</f>=<a>before</f> + <b>safe</f> vt.保存;保護;保藏
pressure=n.[U,C]壓力
pretend=v.假裝
previous=adj.先前的,以前的
<a>prim</f>itive=<a>initial</f> adj.原始的
principal=n.校長 adj.主要的
priority=n.[C,U]優先
private=adj.私人的
<a>privi</f><b>leg</f>e=<a>individual</f> + <b>law</f> n.[C,U]特權
prize=n.獎
procedure=n.[C,U]程序,步驟
<b>pro</f><a>ceed</f>=<b>before</f> + <a>to go</f> v.前進
<b>pro</f><a>cess</f>=<b>forward</f> + <a>move</f> n.[C]過程 v.處理
<b>pro</f><a>duce</f>=<b>forward</f> + <a>lead</f> 向前引導<d>→</f> v.製造
proficient=n.精通 adj.流利的,(熟練的)
profit=n.[C,U]利潤
prohibit=v.禁止
<b>pro</f><a>ject</f>=<b>forward</f> + <a>throw</f> n.計劃         v.投射
prominent=adj.傑出的,突出的
<a>pro</f><b>mot</f>e=<a>forward</f> + <b>move</f> v.促銷,提升
<a>pro</f><b>mpt</f>=<a>forward</f> + <b>take</f> adj.迅速的,即時的
proper=adj.適合的;適當的
property=n.[C,U]特性,財產
<b>pro</f><a>pose</f>=<b>forward</f> + <a>to place</f> 建議
<b>pro</f><a>spect</f>=<b>forward</f> + <a>to look</f> n.[C,U]前景 v.勘查
prosper=adj.繁榮的
prosperous=adj.繁榮的
<a>pro</f><b>test</f>=<a>forth</f> + <b>witness</f> n.(v.)抗議
prove=v.證實
<a>pro</f><b>vide</f>=<a>before</f> + <b>to see</f> v.提供
province=n.省份
public=adj.公眾的,公開的
publish=v.出版
punish=v.處罰
purchase=v.(n.)購買
<b>pur</f><a>pose</f>=<b>forth</f> + <a>to place</f> 目的,用途
<a>pur</f><b>sue</f>=<a>forward</f> + <b>follow</f> v.追求
puzzle=v.困惑
qualification=n.資格,條件
qualified=adj.有資格的
qualify=v.有資格
quality=n.品質
quantity=n.量,大量
quarrel=v.(n.)口角
race=n.種族,競賽
racism=n.種族主義
rage=n.憤怒
random=adj.隨意的
range=n.範圍
rapid=adj.快速的
rare=adj.稀有的
<a>re</f><b>act</f>ion=<a>back</f> + <b>to do</f> n.[C]反應
<b>real</f><a>istic</f>=<a>full of</f> + <b>real</f> adj.實際的
<b>real</f><a>ize</f>=<a>make</f> + <b>real</f> v.實現,領悟
rear=n.養育 adj.後面的
<b>re</f><a>bel</f>=<b>against</f> + <a>war</f> v.反抗
<a>re</f><b>call</f>=<a>back</f> + <b>call</f> v.回想 n.召回
receipt=(v.)n.收據
<a>re</f><b>ceiv</f>e=v.收到
recent=adj.近來的,新近的
recession=n.[C,U]退後,退回
<a>re</f><b>cite</f>=<a>back</f> + <b>summon</f> v.背誦
<a>re</f><b>cogni</f>ze=<a>again</f> + <b>know</f> v.認識,認出,認清
<a>re</f><b>com</f><c>mend</f>=<a>again</f> + <b>together</f> + <c>repaired</f> v.推薦
<a>re</f><b>crea</f><c>tion</f>=<a>again</f> + <b>create</f> + <c>action</f> n.娛樂
<a>re</f><b>cycl</f>e=v.(n.)回收
<b>re</f><a>duce</f>=<b>back</f> + <a>lead</f> 往回引導<d>→</f> v.減少
<b>re</f><a>flect</f>=<b>back</f> + <a>bend</f> v.反映,反省
<b>re</f><a>form</f>=<b>again</f> + <a>shape</f> 再形成<d>→</f> n.[C,U]改革
<a>re</f><b>fuge</f>=<a>back</f> + <b>flee</f> n.[C,U]避難
refugee=n.難民
refuse=v.拒絕 n.廢物
regarding=prep.有關於
region=n.地區,地域,地帶
regret=v.懊悔 n.遺憾
regular=adj.規則的
regulation=n.規則
rehearsal=n.彩排
<b>re</f><a>ject</f>=v.拒絕
relate=v.聯想,有關於
related=adj.相關的
relation=n.關係
relatively=adv.(adj.)相對地(的)
<a>re</f><b>lax</f>=v.放鬆
release=v.(n.)釋放,發布
reliable=adj. 可靠的
relief=n.輕鬆
relieve=v.減輕(負擔、痛苦),拯救
religion=n.[C,U]宗教
reluctant=adj.不情願的
rely=v.依賴
<a>re</f><b>main</f>=<a>back</f> + <b>stay</f> v.依然
remark=v.評論 n.談論,言論
remarkable=adj.非凡的
remedy=v.治療
remind=v.提醒
remote=adj.遙遠的
renowned=adj.有名的
<a>re</f><b>pair</f>=<a>again</f> + <b>prepare</f> v.修理
replace=v.取代
reply=v.(n.)回答,答覆
report=v.報告,報導
represent=v.代表
reputation=n.[C,U]名譽,名聲
resemble=v.相像 adj.相像的
<a>re</f><b>sent</f>=<a>intensive</f> + <b>to feel</f> v.憎恨
<a>re</f><b>serve</f>=<a>back</f> + <b>save</f> v.保留,預約
<a>re</f><b>sid</f>e=<a>back</f> + <b>sit</f> v.居住
resident=n.[C]居民,定居者,僑民
<a>re</f><b>sign</f>=<a>opposite</f> + <b>mark</f> v .辭職 n.辭去(職務)
<a>re</f><b>sist</f>=<a>back</f> + <b>stand</f> v.抵抗
resolution=n.[C]決心
<a>re</f><b>sort</f>=<a>again</f> + <b>go out</f> v.訴諸 n.名勝
resource=n.[C]資源
<b>re</f><a>spect</f>=<b>again</f> + <a>to look</f> n.尊敬,方面 v.尊敬
<a>re</f><b>spons</f>e=<a>back</f> + <b>pledge</f> n.[C]回應
responsibility=n.[C,U]責任
rest=v.(n.)休息
restrict=v.限制
result=n.結果
<b>re</f><a>sum</f>e=n.履歷表 v.再開始(恢復）
retire=v.退休
reveal=v.揭露
revenge=v.(n.)報復
<a>re</f><b>vers</f>e=<b>turn</f> + <a>back</f> adj.相反的
<a>re</f><b>view</f>=<a>again</f> + <b>to see</f> v.複習 n.評論
<b>re</f><a>volu</f>tion=n.革命
reward=n.(v.)獎勵
rid=v.去除
ridiculous=adj.可笑的
risky=adj.危險的
ritual=n.儀式
<b>riv</f><a>al</f>=n.對手
rude=adj.粗魯的,無禮的
ruin=v.破壞
rule=n.規則 v.統治
rural=adj.鄉村的
sacrifice=v.犧牲
sample=n.樣本 v.抽樣
<a>satis</f><b>fy</f>=<a>enough</f> + <b>perform</f> v.使滿意
save=v.儲存,拯救
scandal=n.[C,U]醜聞
scarce=adj.缺少的
scare=v.使害怕
scatter=<d>音{撕開它}</f> v.散亂
scenery=n.[C]風景,景色
schedule=v.安排,計畫
scold=v.責備
sculpture=v.雕刻
search=v.(n.)搜查
season=n.季節 v.調味
<b>securi</f><a>ty</f>=<b>secure</f> + <a>condition</f> n.[C,U]安全
seek=v.尋求
seem=v.好像,似乎
seemingly=adv.表面上
seize=v.抓住
<a>se</f><b>lect</f>=<a>apart</f> + <b>choose</f> v.選擇
sensation=n.知覺,轟動的人物
sense=n.道理,意識 v.感覺
sensible=adj.明理的,合理的
sensitive=adj.敏感的
sentence=n.句子 v.判決
sentiment=n.情感
<a>sent</f>i<b>ment</f>al=<a>feeling</f> + <b>result</f> adj.傷感的
<a>se</f><b>par</f>ate=<a>apart</f> + <b>prepare</f> adj.分開的 v.分開
serve=v.提供,服務於....
severe=adj.嚴重的,嚴厲的
shallow=adj.膚淺的
shelter=v.掩蔽,保護
shift=v.(n.)轉變
<b>short</f><a>age</f>=n.短缺
shortcut=n.捷徑
shrink=v.縮小
sign=n.象徵,符號  v.簽名
<a>sign</f>al=n.信號,動機 v. 發信號,打手勢
signature=n.[C]簽名
silent=adj.安靜的
<a>simil</f>ar=<a>like</f> adj.相似的
simply=adv.簡單地,僅
simultaneous=adj.同時的
sincere=adj.誠摯的
sink=v.下沉
situation=n.[C]情勢,情況,處境
skill=n.技能,技藝
slight=adj.輕微的
slogan=n.口號
smooth=adj.平順的
sneeze=v.打噴嚏
<a>sol</f>ar=<a>sun</f> adj.太陽的
solid=adj.堅固的
solution=n.解決,溶液
soothe=v.撫慰
<a>sou</f><b>venir</f>=<a>up</f> + <b>come</f> n.[C]紀念品
spare=adj.空閒的,備用的
species=n.[C]種,種類
specific=adj.明確的
spectacular=adj.驚人的
speculate=v.猜測,投機
<a>spir</f>it=<a>soul</f> n.精神
<a>spir</f>itual=<a>soul</f> adj.精神的
<a>spons</f>or=<a>pledge</f> v.資助
spontaneous=adj.自發的,自然產生的
spread=v.散佈
stable=adj.穩定的
stage=n.舞臺,階段
stale=adj.不新鮮的
standard=n.標準 adj.標準的
startle=v.驚訝
state=n.狀態 v.陳述
stationary=adj.靜止的
status=n.[C,U]地位
steady=adj.穩定的
stimulate=v.刺激
<a>str</f><b>ategy</f>=<a>spread</f> + <b>leader</f> n.[C]策略,方法
stray=v.迷路 adj.走失的
strengthen=v.加強
stress=v.(n.)強調,壓力
stretch=v.伸展,延伸
strict=adj.嚴格的
strike=v.(n.)罷工 n.襲擊
striking=adj.醒目的,顯著的
strip=n.[C]條 v.剝奪
strive=v.努力,奮鬥
<a>struct</f>ure=<a>build</f> n.[C]結構,構造
struggle=v.(n.)鬥爭,奮鬥
stun=v.驚訝 n.暈眩,打昏,驚倒
<a>sub</f><b>mit</f>=<a>under</f> + <b>send</f> v.繳交,屈服
<a>sub</f><b>scrib</f>e=<a>underneath</f> + <b>write</f> v.簽名,訂購
substance=n.[C]物質
substitute=n.[C]替代
<a>suc</f><b>cumb</f>=<a>down</f> + <b>lie</f> v.屈服
sudden=adj.突然的
<a>suf</f><b>fer</f>=<a>up(sub)</f> + <b>carry</f> v.遭受
sufficient=adj.足夠的,充分的
<a>sug</f><b>gest</f>=<a>up</f> + <b>carry</f> v.建議,顯示
<b>sui</f><a>cide</f>=n.自殺
<b>super</f><a>fici</f>al=<b>above</f> + <a>face</f> 在臉上面<d>→</f> adj.膚淺的
supply=v.供應
<b>sup</f><a>port</f>=<b>under</f> + <a>carry</f> v.支持
suppose=v.猜想,假設
surrounding=adj.周圍的;附近的
<b>sur</f><a>viv</f>e=<b>over</f> + <a>alive</f> v.生存
<b>su</f><a>spect</f>=<b>up to</f> + <a>look</f> v.懷疑 n.嫌疑犯
<b>sus</f><a>pend</f>=<b>under</f> + <a>hang</f> v.中止,懸吊
<b>sus</f><a>pens</f>e=<b>under</f> + <a>hang</f> n. 懸念,中止
suspicious=adj.懷疑的
sustain=v.維持
swallow=n.[鳥]燕子,吞嚥
sweep=v.掃,席捲
<a>sym</f><b>bol</f>=n.(v.)象徵
<b>sym</f><a>pathy</f>=<b>together</f> + <a>feeling</f> n.[U]同情
symptom=n.[C]症狀
<a>syn</f><b>drome</f>=<a>together</f> + <b>to run</f> n.症狀
<a>sy</f><b>ste</f>m=<a>together</f> + <b>stand</f> n.[C]系統
talent=n.天份
target=n.目標
task=n.任務
tear=v.撕,拆 n.眼淚
tease=n.(v.)嘲笑
<a>techn</f>ique=<a>skill</f> n.[C]技巧
<a>techn</f><c>ology</f>=<a>skill</f> + <c>study of</f> n.[C,U]科技
temper=<d>音{太潑}</f> n.[C]脾氣
temperature=n.[C,U]溫度
temple=n.寺廟
<a>tempor</f>ary=adj.暫時的
tempt=v.誘惑
tend=v.傾向
tendency=n.[C]趨勢,潮流
tender=adj.柔和的,滑嫩的
tension=(n)v.緊張
terrify=v.嚇人,使...害怕
<a>terr</f>itory=n.領土
<a>test</f><b>ify</f>=<a>witness</f> + <b>make</f> v.證實
theory=n.[C,U]理論
therapy=n.[C,U]治療
thick=adj.濃厚的
thoughtful=adj.體貼的
threat=n.[C,U]恐嚇;威脅
thrive=v.繁榮
thus=adv.所以
tidy=adj.整齊的
tight=adj.緊的,密封的
time-consuming=adj.耗時的
timid=adj.害羞的
tiny=adj.微小的
to run errands=ph.跑腿
tolerate=v.忍受
<a>tort</f>ure=<a>to twist</f> n.(v.)折磨
tough=adj.堅韌的,強硬的
trade=n.貿易 v.交換
tradition=n.傳統
tragedy=n.[C,U]悲劇
train=n.列車,一列 v.訓練
trait=n.特色
transact=v.交易
<a>trans</f><b>cend</f>=<a>across</f> + <b>to climb</f> v.超越
<b>trans</f><a>fer</f>=<b>across</f> + <a>to carry</f> v.轉移
<b>trans</f><a>form</f>=<b>turn</f> + <a>shape</f> v.改變
<a>trans</f><b>it</f>=<a>across</f> + <b>to go</f> v.運送,轉變
<a>trans</f><b>late</f>=<a>over</f> + <b>carried</f> v.翻譯
<a>trans</f><b>mit</f>=<a>across</f> + <b>send</f> v.傳送
transparent=adj.透明的
transportation=n.[U]交通,運輸
treasure=n.寶藏 v.珍視
treat=v.治療,對待
tremendous=adj.巨大的,極好的
trend=n.[C]趨勢
trick=n.詭計,欺騙
trifle=n.瑣事
triumph=n.[C]勝利,征服 v.戰勝
trivial=adj.瑣碎的
tropical=adj.熱帶的;位在熱帶的
typical=adj.典型的;象徵性的
ultimate=adj.最終的
uncover=v.揭開
unexpected=adj.意外的
<b>uni</f><a>form</f>=<b>one</f> + <a>shape</f> 一種形狀<d>→</f> n.制服
<a>uni</f>que=<a>one</f> adj.獨特的
universal=adj.全世界的,普遍的
unless=prep.除非
until=prep.conj.直到
upset=adj.不適的
<a>urb</f><c>an</f>=<a>city</f> + <c>pertaining to</f> adj.城市的,市內的
urge=v.催促,要求
urgent=adj.緊急的
utilize=v.利用
<a>vac</f>ant=<a>empty</f> adj.空缺的
vacation=<d>音{我開心}</f> n.假期
vague=adj.模糊的
vain=adj.徒然的
<a>valu</f>e=<a>worth</f> n.價值 v.重視
<a>vani</f>sh=<a>empty</f> v.消失
vanity=n.虛榮心,浮華
variety=n.[U,C]種類
various=adj.各式各樣的
vary=v.變化
vast=adj.巨大的
<a>vers</f>ion=<a>to turn</f> n.[C]版本
via=prep.經由,取道
<a>vict</f>im=n.受害者
victory=n.勝利
vigor=n.活力
violate=v.違反
violence=n.猛烈,暴力
virtually=adv.實際地,虛擬地
virtue=n.美德
virus=n.[C]病毒
visual=adj.視覺的
<a>vita</f>l=<a>alive</f> adj.活力的,致命的,重要的
<a>vol</f>unt<b>eer</f>=<a>to wish</f> + <b>person</f> n.[C]志願,義工
vote=n.投票
vow=v.(n.)發誓
voyage=v.(n.)旅行 n.航程
vulgar=adj.粗俗的
vulnerable=adj.脆弱的
wage=n.薪資
wander=v.徘徊
warn=v.警告,預先通知
warranty=n.保證
waste=v.浪費 n.廢物
weaken=v.減弱
wealthy=adj.富裕的,富庶的
weird=adj.奇怪的
welfare=n.福利(祉)
whereas=conj.而,卻
whisper=n.(v.)耳語
whistle=n.(v.)口哨
widely=adv.廣泛地
widespread=adj.遍佈的
willing=adj.有意願的
<b>with</f><a>draw</f>=<b>back</f> + <a>to draw</f> v.提款,撤退
<b>with</f><a>sta</f>nd=<b>back</f> + <a>stand</f> v.抵擋
witness=n.[律]證人 v.目睹
wonder=v.想知道,詫異 n.奇跡
worldwide=adj.(adv.)全世界的
worship=n.(v.)崇拜
worth=n.價值
wrap=v.(n.)包裹
yearn=v.渴望
yet=conj.但是,然而
zone=n.[C]區域
consist of=ph.包括
cope with=ph.處理
correspond with=ph.互通訊息
correspond to=ph.一致
decease=n.(v.)死亡
well-being=ph..福利
manage to=ph.設法
deal with=ph.處理,討論
arise (from)=v.產生(由於)
yield(to)=v.生產
belong(to)=v.屬於
appeal to=ph.吸引
be subject to=ph.易遭受
regardless of=ph.儘管
frantical=adj.狂熱的
dispose of=ph.處理,丟棄
count(on)=v.計算,指望
