Aries=白羊座,白羊宮
Taurus=金牛座
Gemini=雙子星座
Cancer=巨蟹星座
Leo=獅子座
Virgo=處女座
Libra=天秤(星)座
Scorpio=天蠍座
Sagittarius=射手座
Capricorn=摩羯座
Aquarius=寶瓶(星)座
Pisces=雙魚座
Sun=太陽
Moon=月亮
Mercury=水星
Venus=金星
Mars=火星
Jupiter=木星
Saturn=土星
Uranus=天王星
Neptune=海王星
Pluto=冥王星
Eris=[希神]厄里斯 (希臘神話)宙斯和赫拉之女,不和之女神,司紛爭的女神,她是戰神阿瑞斯(Ares)的姐妹,夜的女兒,貧窮、爭吵、饑餓的母親,最喜挑起不和,最著名的成就是在珀琉斯和忒提斯的婚宴上投下的不懷好意的贈品而挑起了(特洛伊之戰).
ceres=穀神星,我們的星盤中代表了我們所接收到的早期的養育(關愛)和我們是如何養育(關愛)他人的
Vesta=灶神星 is the keeper of the hearth. She is focus and dedication. She is mental clarity and self-respect.
Pallas=智神星,同時也是女神雅典娜的羅馬名字)表示了我們對規律的預見,及安排組織解決事情的能力
Chiron=凱龍
Juno=婚神君 in the horoscope gives a good indication of the kind of marriage partner that we need and will get.
Vertex=宿命點
sidereal=[天]星的,恆星的
Eridanus=波江(星)座
regulus=軒轅十四在拉丁語中是「王子」或「小國王」的意思。希臘語的變體Basiliscus及Qalb Al Asad也被使用來稱呼軒轅十四,Qalb Al Asad是從阿拉伯語 قلب الأسد qalb演生出來的,意為「獅子的心臟」
Nessus=Melanie Reinhart relates Nessus to issues surrounding sexuality, death, revenge and jealousy.
Eros=愛神星;在希臘神話中是司「欲望」之原始神.
quincunx=150度,五點排列成的梅花狀,[植]梅花點式
opposite=180度;
conjunction=0度;合相
sesquiquadrate=135度
ecliptic=[天]黃道
theurgic=adj.法力的,神力的;(埃及新柏拉圖派所傳授和施行的)巫術的
celestial=天的,天空的
solstice=[天]至
equinox=晝夜平分時(春分或秋分)
quadrant=四分之一圓周,九十度弧;[數]象限
crescent=新月,弦月[C]
astronomer=天文學家[C]
vernal=春分
equator=赤道[the S]
equidistant=adj.等距離的
ecliptic coordinate system=黃道坐標系
ephemeris=[天]星曆表,(帶星曆表的)曆書
almanac=n.年鑒,年歷
meridian=n.[天][測]子午線,經線[C];(太陽等天體對地面而言的)最高點[the S];頂點;全盛期[the S]
decan=黃道十度分度
prenumbral=日月半陰影的,曖昧的部分的,微妙的氣氛的
aphelion=n.[天]遠日點
Pholus=was mortally wounded by an unexpected coincidence, being punctured by a poisoned arrow he was removing from Chiron.
elliptical=adj.橢圓的;橢圓形的,省略的
synodical=adj.宗教會議的,會議的;[天]會合的
totality=n.[天]全食(的時間)
metonic cycle=a period of 19 years (235 lunar months), after which the new and full moons return to the same day of the year. It was the basis of the ancient Greek calendar, and is still used for calculating movable feasts such as Easter.
perigee=n.[天]近地點;最低點
decan=Each astrological sign can be divided into three sections, known as decans (10 degree divisions of the Zodiac).
sidereal=[天]星的,恆星的
Ptolemaic=adj.托勒密的,埃及托勒密王朝的
